protein_id,sequence,true_cleavage_site,predicted_cleavage_site,rounded_prediction,absolute_error
A1X158,MARNMNILTLFAVLIGSASAVYHPPSWTAWIAPKPWTAWKVHPPAWTAWKAHPPAWTAWKATPKPWTAWK,20,21.01331,21,1
D3Z9M3,MLVILLMVVVLALSSAQDPNRDFVVSSQDVRERQPSSQQGTVGGQSQESQLRDQQQQQSLQQSQEQQPQP,16,17.509968,18,2
P42264,MTAPWRRLRSLVWEYWAGFLVCAFWIPDSRGMPHVIRIGGIFEYADGPNAQVMNAEEHAFRFSANIINRN,31,29.292301,29,2
C9K4X8,MTSNNRHLFQATCLVLLLLHAAFHGGALGEKYCDDDFHMAVFRTCAVSKRSQPGMSLSDVLTMNRFRGHN,29,28.596508,29,0
P55203,MTACTFLAGGLRDPGLCGPTRWAPSPPGLPPIPPRPRLRLRPPLLLLLLLPRSVLSAVFTVGVLGPWACD,56,37.33568,37,19
Q2U4L7,MMHFLSFCLSVASLVSYAGAASTFSPARPPALPLAVKSPYLSTWLSAGTDGGNGGYLAGQWPTFWFGQVT,20,19.908546,20,0
P01824,MDLMCKKMKHLWFFLLLVAAPRWVLSQLQLQESGPGLVKPSETLSLTCTVSGGSISSSSYYWGWIRQPPG,26,27.618399,28,2
P86100,MTQNIQMTEMYQIILFASILAAISATSADFKVVWEVPSIMCSKKFKINVTDLLTSHKILVNQEETFNGDK,25,27.535717,28,3
C4NZN9,MRVLLILVSLAALAHAESFLKSKTGYQGVQTLPGFIGGSQPHLGGGIGGGRPFISQPNLGGGIGGGIGGG,16,17.104828,17,1
P08069,MKSGSGGGSPTSLWGLLFLSAALSLWPTSGEICGPGIDIRNDYQQLKRLENCTVIEGYLHILLISKAEDY,30,28.776443,29,1
Q9GZZ8,MKFTTLLFLAAVAGALVYAEDASSDSTGADPAQEAGTSKPNEEISGPAEPASPPETTTTAQETSAAAVQG,19,18.105484,18,1
P23631,MISVGEIMERANHSLVRMRREGEDLTLEEKAEICSELELQQKYVDIASNIIGDLSSLPIAGKIAGTIAAA,20,11.666974,12,8
Q8WPD0,MAFFRALCFVLLVGFAAACQPDCSWKCPPKCPPMWTFYNGNCYRYFGTGKTYDEAESHCQEFTEVGLGHL,18,16.4715,16,2
Q61001,MAKRGGQLCAGSAPGALGPRSPAPRPLLLLLAGLALVGEARTPGGDGFSLHPPYFNLAEGARITASATCG,40,37.265976,37,3
P32004,MVVALRYVWPLLLCSPCLLIQIPEEYEGHHVMEPPVITEQSPRRLVVFPTDDISLKCEASGKPEVQFRWT,19,21.57039,22,3
Q55P57,MRGLAKLFFLSCSFVSLVSSEKTDESPTAVSDNYMPKATATIDPSVFALSNDFEITDVPTTREYTFDIAK,20,17.914326,18,2
Q2ULM2,MRSLLWASLLSGVLAGRALVSPDEFPEDIQLEDLLEGSQQLEDFAYAYPERNRVFGGKAHDDTVNYLYEE,16,17.652584,18,2
P13612,MAWEARREPGPRRAAVRETVMLLLCLGVPTGRPYNVDTESALLYQGPHNTLFGYSVVLHSHGANRWLLVG,33,32.693924,33,0
P08648,MGSRTPESPLHAVQLRWGPRRRPPLLPLLLLLLPPPPRVGGFNLDAEAPAVLSGPPGSFFGFSVEFYRPG,41,36.776627,37,4
P24063,MSFRIAGPRLLLLGLQLFAKAWSYNLDTRPTQSFLAQAGRHFGYQVLQIEDGVVVGAPGEGDNTGGLYHC,23,21.70086,22,1
P16144,MAGPRPSPWARLLLAALISVSLSGTLANRCKKAPVKSCTECVRVDKDCAYCTDEMFRDRRCNTQAELLAA,27,27.1366,27,0
P26006,MGPGPSRAPRAPRLMLCALALMVAAGGCVVSAFNLDTRFLVVKEAGNPGSLFGYSVALHRQTERQQRYLL,32,23.145237,23,9
P08514,MARALCPLQALWLLEWVLLLLGPCAAPPAWALNLDPVQLTFYAGPNGSQFGFSLDFHKDSHGRVAIVVGA,31,25.100275,25,6
P38570,MWLFHTLLCIASLALLAAFNVDVARPWLTPKGGAPFVLSSLLHQDPSTNQTWLLVTSPRTKRTPGPLHRC,18,19.242548,19,1
P11215,MALRVLLLTALTLCHGFNLDTENAMTFQENARGFGQSVVQLQGSRVVVGAPQEIVAANQRGSLYQCDYST,16,19.750978,20,4
P17301,MGPERTGAAPLPLLLVLALSQGILNCCLAYNVGLPEAKIFSGPSSEQFGYAVQQFINPKGNWLLVGSPWS,29,26.835289,27,2
C0HJQ4,MKMFFTVLVTLFVCSMIIGICEGREIPVKCKGSKQCLQSCKEAGMTYGKCMNGKCNCTPKG,23,18.683952,19,4
Q00870,MMISSVLVAGVVAVSAALASKHPKQYSFKPEDAETIWNGDIPVLYDFGDSQSASYSGSWWTSSYITGTNG,19,18.127888,18,1
P19137,MRGSGTGAALLVLLASVLWVTVRSQQRGLFPAILNLATNAHISANATCGEKGPEMFCKLVEHVPGRPVRH,24,23.56017,24,0
C0HJQ5,MSRLYAIILIALVFNVIMTIMPDMKVEAVSCEDCPPHCATKDQRAKCENDKCVCEPK,28,22.606964,23,5
C7G3K3,MAKHLIVMFLVIMVISSLVDCAKKPFVQRVKNAASKAYNKLKGLAMQSQYGCPIISNMCEDHCRRKKMEG,21,20.130566,20,1
P86929,MLLTISDFLFLSLTFSRYARMRDSRPWSDRKNNYSGPQFTYPPEKAPPEKLIKWNNEGSPIFEMPAEGGH,14,17.476273,17,3
Q14392,MRPQILLLLALLTLGLAAQHQDKVPCKMVDKKVSCQVLGLLQVPSVLPPDTETLDLSGNQLRSILASPLG,19,19.425674,19,0
P01705,MAWALLLLTLLTQDTGSWAQSALTQPASVSGSPGQSITISCTGTSSDVGSYNLVSWYQQHPGKAPKLMIY,19,18.416931,18,1
C5P3X6,MRVSVPVLALAFGSLAAAAPNAGRRTCGSVPPPEFFEASEKVAALEESGAFADLQAPIEVETYFHVVASS,18,17.735146,18,0
Q8C1Q4,MLVATLLCALCCGLLAASAHAGYSEDRCSWRGSGLTQEPGSVGQLTLDCTEGAIEWLYPAGALRLTLGGP,21,18.36762,18,3
B0FHH8,MAALHWLLLAALLGCTLAEEQAIFYNCEEASEAVCSVKEVRINPCNPNKKCIFKKGVNASISFDFEPNFA,18,14.522428,15,3
Q8X150,MRSRILAIVFAARHVAALPLAAEDAAATLSLTSSASSTTVLPSPTQYTLPNNDPNQGARNASIARKRELF,16,20.871643,21,5
P45452,MHPGVLAAFLFLSWTHCRALPLPSGGDEDDLSEEDLQFAERYLRSYYHPTNLAGILKENAASSMTERLRE,19,20.817013,21,2
Q59XX2,MLFKSFVTFTVLANALAAPLAHQHHQHKEEKRAVHVVTTTNVVVVTIGNGDQTTTFAAPSVAAESSVSVS,32,19.62258,20,12
P86872,MRRILCLAVVIFIINDVSSQGLGSNKNWKKSGMSLSSPGNKKPTGNNNAVPQKSKMNNVNQNSLSQPKRP,19,17.574158,18,1
P28665,MWKSRRAQLCLFSVLLAFLHSASLLNGDSKYMVLVPSQLYTETPEKICLHLYQLNETVTVTASLVSQSGR,27,20.30256,20,7
Q9UK23,MATSTGRWLLLRLALFGFLWEASGGLDSGASRDDDLLLPYPRARARLPRDCTRVRAGNREHESWPPPPAT,25,24.697298,25,0
P10493,MLDASGCSWAMWTWALLQLLLLVGPGGCLNRQELFPFGPGQGDLELEAGDDVVSPSLELIGELSFYDRTD,28,26.567863,27,1
Q14112,MEGDRVAGRPVLSSLPVLLLLPLLMLRAAALHPDELFPHGESWGDQLLQEGDDESSAVVKLANPLHFYEA,30,30.047417,30,0
P86407,MNKKILLVIFIVTMLIVDEVNSFKFGSFIKRMWRSKLAKKLRAKGKELLRDYANRVLSPEEEAAAPAPVP,22,20.010143,20,2
Q6ASY2,MAVAARAAAVACLLVVGLAAVAGVDGATASSPAPAPAVDCTAEALKLADCLDYVTPGKTAPSRPSKLCCG,26,22.123055,22,4
A0A161AT60,MARSMKLACVALVICMVVIAPMAEAALSCGTVSADMAPCVTYLQAPNNASPPPPCCAGVKKLLAAATTTP,25,23.046095,23,2
O42414,MVLHSHQLTYAGIAFALCLHHLISAIEVPLDSNIQSELPQPPTITKQSVKDYIVDPRDNIFIECEAKGNP,25,27.451015,27,2
Q3L1D1,MIPRVAKFNFRLLSLALLGIQVARSAITYQNPTDLPGDVDYDFIVAGGGTAGLVVASRLSENPEWNVLVI,25,26.51265,27,2
P07897,MTTLLLVFVTLRVIAAVISEEVPDHDNSLSVSIPQPSPLKALLGTSLTIPCYFIDPMHPVTTAPSTAPLT,19,18.313217,18,1
P25116,MGPRRLLLVAACFSLCGPLLSARTRARRPESKATNATLDPRSFLLRNPNDKYEPFWEDEEKNESGLTEYR,21,12.301658,12,9
Q63415,MPPRAPPAPGPRPPPRAAGRHGLSPLAPRPWRWLLLLALPAVCSALPPPRPVYTNHWAVQVLGGPGAADR,45,36.69979,37,8
P09619,MRLPGAMPALALKGELLLLSLLLLLEPQISQGLVVTPPGPELVLNVSSTFVLTCSGSAPVVWERMSQEPP,32,28.00632,28,4
Q8W257,MSLNRVLHIFLIAYLACTALTHDFDDTIAVVGAGYSGLSAAFTLVKKGYTNVEIYESQGEVGGYVYSVDY,21,17.503826,18,3
P47853,MRPLWLLTLLLALSQALPFEQKGFWDFTLDDGLLMMNDEEASGSDTTSGVPDLDSLTPTFSAMCPFGCHC,16,17.543304,18,2
Q9GL30,MSRHSQDERLGLPQPPALLPLLLLLLAVAVPLSQAGVYYATAYWMPTEKTIQVKNVLDRKGDAYGFYNNS,35,32.838615,33,2
P11654,MARASLIQPGLWALLLLQAVGPAVAAKLNIPKVLLPFTRATRVNFTLEASEGCYRWSSTRPEVASIEPLG,25,23.409521,23,2
P49259,MPLLSLSLLLLLLQVPAGSAETAAWAVTPERLREWQDKGIFIIQSENLEKCIQASKSTLTLENCKPPNKY,20,18.293259,18,2
Q868Z9,MDLSRRLCSTALVAFIVLASIHDSQSRFPGLRQKRQYGANMYLPESSVTPGGEGNDPDEWTPWSSPSDCS,26,21.95242,22,4
P0C8G6,MSQLRWWVVSQLLLLIVVCILDHSEGARVCPKIVPGLDKLRVGVDITKLDLLPLFDLGDNGFRSAVADYT,26,20.881004,21,5
Q99969,MRRLLIPLALWLGAVGVGVAELTEAQRRGLQVALEEFHKHPPVQWAFQETSVESAVDTPFPAGIFVRLEF,20,18.256233,18,2
Q62703,MRLGPRPAVLGLLLLLLLYAAVAGASKAEELHYPQGEHRADYDRETLLGVQEDVDEYVKLGHEEQQRRLQ,25,23.36929,23,2
Q7SZI7,MPPLFQALTTALFFCGIASNPLFQPSLVMDMAKVLLDNYCFPENLVGMQETIEQAVKGGEILHISDPDTL,22,19.586597,20,2
Q8BPM6,MAYSTVQRVALASGLVLAVSLLLPKAFLSRGKRPEPPPGPEGKLDRFPPMMHHHSAPSDGQTPGARFQRS,31,25.04723,25,6
P60153,MMRTLITTHPLPLLLLPQQLLQLVQFQEVDTDFDFPEEDKKEEFEECLEKFFSTGPARPPTKEKVKRRVL,26,21.87329,22,4
A5HAK0,MGIHQCTAVVLLLLCASLSTYGQPAEIRRRYEHFLTQHVYGGITEQTCDRVMRQRRITRFPTGNDCKEVN,22,20.754173,21,1
G4V4F9,MKTLFVFAVGIMLSMRASAFTCPECRPELCGDPGYCEYGTTKDACDCCPVCFQGPGGYCGGPEDVFGICA,19,18.54022,19,0
Q8IUH8,MACLGFLLPVGFLLLISTVAGGKYGVAHVVSENWSKDYCILFSSDYITLPRDLHHAPLLPLYDGTKAPWC,21,21.26487,21,0
D7UQ40,MRLIILNLLSLGITPSVVGHSGPHRQETQNLNNFLESNAINPAAINGETRHTGGVHLACAILEASNQTAV,25,17.708675,18,7
O54861,MERPRGAADGLLRWPLGLLLLLQLLPPAAVGQDRLDAPPPPAPPLLRWAGPVGVSWGLRAAAPGGPVPRA,31,29.310516,29,2
P23502,MKLLLLNILLLCCLADKLNEFSADIDYYDLGIMSRGKNAGSWYHSYTHQYDVFYYLAMQPWRHFVWTTCE,15,17.652332,18,3
Q8TCT7,MAAAVAAALARLLAAFLLLAAQVACEYGMVHVVSQAGGPEGKDYCILYNPQWAHLPHDLSKASFLQLRNW,25,21.688889,22,3
Q966V2,MAAINVIFISGAIALFALTGSCSESTNPFTNKPYATQNPYSPPQTNQPTKRPYQPGPAPTPAPYIPQKTN,22,18.945671,19,3
Q9YH85,MNTRSLLSAWAALLVVTVRHRAHAMASLYPFWPNDTKTPKVDDGSSSEIKLSVPFIFFRSPYRTVYVNNN,24,21.237007,21,3
Q02763,MDSLASLVLCGVSLLLSGTVEGAMDLILINSLPLVSDAETSLTCIASGWRPHEPITIGRDFEALMNQHQD,22,20.545177,21,1
P35590,MVWRVPPFLLPILFLASHVGAAVDLTLLANLRLTDPQRFFLTCVSGEAGAGRGSDAWGPPLLLEKDDRIV,21,22.945099,23,2
Q4V645,MTKTTMHWLAHFQIILLCIWLMCPPSSQAIKCDTCGKECASACGTKHFRTCCFNYLRKRSDPDALRQSSN,29,25.622368,26,3
I6S7I0,MKNKFAALVITLFVLVLAIDNVTTQCLEGCECNQESTGKTCRPKQGSNVSPAVCLAQYCYHGYC,18,22.85313,23,5
I6S7G5,MSWMFYSFIVFTLAIKEVIAIDGLEICSNDQLHVTIYSIFSPLFDKPKLNYYFNCSCPGSIYISDVYPKY,16,21.218264,21,5
G5ED35,MSRFLIYFLPFFIYSGNVLSKTSCLMATGVLKCPTDPEAVKKVHIDLWDEDSLPLESDDLMGRTWSDRNG,20,19.130857,19,1
Q9P2K2,MFSGFNVFRVGISFVIMCIFYMPTVNSLPELSPQKYFSTLQPGKASLAYFCQADSPRTSVFLEELNEAVR,27,23.319023,23,4
P67861,MAAYLLAVAILFCIQGWPSGTVQGQVRPFLDVYERSACQTRETLVSILQEHPDEISDIFRPSCVAVLRCS,24,19.63413,20,4
P35441,MELLRGLGVLFLLHMCGSNRIPESGGDNGVFDIFELIGGARRGPGRRLVKGQDLSSPAFRIENANLIPAV,18,21.644703,22,4
P0DMD3,MTVSCSKVLLSLCLFLMLLKATHESNQQRTNFREFFEIQLAQETREINEKNNQPLNQQLPQLNRRKRLWR,21,22.649578,23,2
Q9JLA3,MCSRGDANAAGAAAARRVTGLCYNMGLLIALALLCLFSLAEANSKAITTSLTTKWFSAPLLLEASEFLAE,42,34.44822,34,8
I6RU32,MNSSIAILLVMALIMFSLDKSYSTDDESGNKCAKTKRRENVCRVCGNRSGNDEYYSECCESDYRYHRCLD,23,21.626736,22,1
I6S390,MAYIYALIFAIVVCMNTDVIQAEESQHDTLENVEYRLSCIPKGGECERMADTCCPGLQCLGCNPFNKENL,22,19.980228,20,2
Q09332,MLRAVALCVSVVLIALYTPTSGESSQSYPITTLINAKWTQTPLYLEIAEYLADEQAGLFWDYVSGVTKLD,22,18.274048,18,4
Q99ML8,MMTRWALVVFVVLMLDRILFVPGTPIPTFQLLPQNSLETTPSSVTSESSSGTTTGPSASWSNSKASPYLD,23,19.477774,19,4
Q09140,MRWGFWFAIATLITICYAAKPLDVKIAATFNAPSFSALIAESLYQEKKEGFIWYLNHLSDLLDAENTTEK,18,18.498049,18,0
Q16927,MATDGITSRFGFNERRRTHNRNSCRILEDKMLAKLLLLALAGLTAAYQYENSFKGYNPGYKGYDAGYKGY,46,37.16885,37,9
Q94637,MRFAVLLALFGLALAARQSSVSEQYYRSGREYRYQFNGHLSAGLPIPGEENSATRIQSLIRIQPENGDFM,15,17.42052,17,2
I2C090,MEGMALYLVAALLIGFPGSSHGALYTLITPGVLRTDTEEQILVEAHGDNTPKQLDIFVHDFPRKQKILFQ,22,21.02975,21,1
P0DL40,MHPIIWELSHMVDLQAAAQKLKRCYQRRVAITAGGLKHRLMSSLIIIIIIRINYLRDNSVIILESSY,21,17.566158,18,3
P35916,MQRGAALCLRLWLCLGLLDGLVSGYSMTPPTLNITEESHVIDTGDSLSISCRGQHPLEWAWPGAQEAPAT,24,21.500216,22,2
Q27309,MKLFVLAAIIAAVSSDRFSSQSQSTGGQTYPSPWQVGKQYRYEVTSRTLAHLQEGPSSGSAFKAQFTIRV,15,15.179161,15,0
P17948,MVSYWDTGVLLCALLSCLLLTGSSSGSKLKDPELSLKGTQHIMQAGQTLHLQCRGEAAHKWSLPEMVSKE,26,21.326544,21,5
Q8WQK0,MSKIILAIFLIVLCGLIFVTVDAMIDAPCKDNDDCDRFTEYCAIYADENGNEAGKRCEDAIGLLV,23,20.005754,20,3
Q6RG02,MTTSTLLFVLAFVAGGLAAPWGADVPRCSTECPVTGSPKLAYQPDKTYAYAYSGKSTVQLKGVDNGDTET,18,18.65462,19,1
P04275,MIPARFAGVLLALALILPGTLCAEGTRGRSSTARCSLFGSDFVNTFDGSMYSFAGYCSYLLAGGCQKRSF,22,20.008116,20,2
Q2PGY1,MPSLTSLFSFFALASGAFSATADLSKRESYTSSSTGTSNGYYYSFWTDGQGDITYSNGAAGEYSVTWSGD,27,19.3015,19,8
Q8J0K5,MGISSILLSALIAGGALALPAAEPVSFDIRDENITLARRAEAINYNQDYIASGANVQYSPNMAAGSFSIN,39,19.068632,19,20
C6JUP2,MKTLLLTLVVVTIVCLDLGNTANTLFCDNSNVPSIRTRKRCLKNQKLCYKMTFFTPGFGWTQIKGCIHRC,21,18.909725,19,2
G5EC68,MFVRSLFLALLLATIVAADIDFSTCARMDVPILKKAAQGLCITSCSMQNCGTGSCKKRSGRPTCVCYRCA,17,18.450766,18,1
Q7M3V1,MAGKEVIFIMALFIAVESSPIFSFDDLVCPSVTSLRVNVEKNECSTKKDCGRNLCCENQNKINVCVGGIM,20,20.220974,20,0
Q9PRI1,MKTLLLTLVVVTIVCLDFGYTIVCYKRHASDSQTTTCLSGICYKKITRGSSRPEMGCGCPQSSRGVKVDC,21,19.299305,19,2
P28335,MVNLRNAVHSFLVHLIGLLVWQCDISVSPVAAIVTDIFNTSDGGRFKFPDGVQNWPALSIVIIIIMTIGG,-1,24.093136,24,25
C6JUP1,MKTLLLTLVVVTIVCLDLGNSLICYNTMMQKVTCPEGKDKCEKYAVPVMRGKFYFSYQCTSKCHEGAYDV,21,19.571646,20,1
C6JUP3,MKTLLLTLVVVTIMCLDLGYTLVCYTNVLEPPGTLETCPDDFTCVKKWEGGGRRVTQYCSHACAIPASYE,21,19.67499,20,1
E3W9M2,MNMSCKFEIVLLVSWWLLLVLVFGVESSMFSEFDRLDFPKHFIFGASSCAYQVEGAAFEDGRTLSTFDIA,30,27.59763,28,2
Q76FP5,MRSIVLPSLALALFSQRARADTTLTIDPTSNWGTWEGWGVSLAWWAKAFGNRDDLASVFFSRNNQAVNGQ,20,18.795628,19,1
Q6Z232,MARLHLVVVAMAALFAAAAVAQGPSASPTPAPKAQPPVATPPTRPPAVAPVSPPAAQPPVTTPPPVSAPA,42,21.050434,21,21
Q84V39,MRGTAGVPDQPVPTPTPSVPTSSSPVPKPPTQGNKKWCVPKAEATDAQLQSNIDYVCSQSGMDCGPIQAN,21,17.312939,17,4
P09230,MKLATAFTILTAVLAAPLAAPAPAPDAAPAAVPEGPAAAAYSSILSVVAKQSKKFKHHKRDLDEKDQFIV,15,19.759731,20,5
P29064,MRSIKAASLTPLLAALFTTLSSTLALPSSVWEHQLETNVLALRDTNNNGSSSTISPSFDVTKCPGYKLVG,35,24.692142,25,10
O88917,MARLAAALWSLCVTTVLVTSATQGLSRAGLPFGLMRRELACEGYPIELRCPGSDVIMVENANYGRTDDKI,24,20.733608,21,3
Q9Z1K9,MRQRLLFLTTLVPFVLAPRPPEEPGSGSHLRLEKLDSLLSDYDILSLSNIQQHSIRKRDLQSATHLETLL,17,19.25563,19,2
Q28989,MPALKIPLFKMKDMVLILCLLKMSSAVPAFPRQPGTPGVASLSLETMRQLGSLQGLNMLSQYSRFGFGKS,26,29.202473,29,3
A9UGV7,MASRILYAAAVVAAVAVSSLAGVAYAADAPAPSPTSGAAAVSSSLVAAVLCPAVALLLGNLRQ,26,24.54906,25,1
P61312,MAQLLMVTVTFGCISLLYLLPGTLSGSLGKGLRPREPPAKIPSSGPQPGHPSLRPVVWKPPHALQPQGRG,25,21.571007,22,3
Q63191,MCLPSCLLSIWVLFMAAQSLGKTWVPDHCRSPTEATCNFVCDCGDCSDEAQCGFHGASTTPNTPFTCNFE,21,20.747753,21,0
A9UGV6,MARFSAAAVIAFAVVAAAALATVASAADAPAPAPTSGAVAAVSAPLSVCCVAGLLLALLRH,26,23.981972,24,2
A9UGV5,MAGQLKSKIVAVAVAAVVVVASSLVGTASAADAPAPAPTSGATATAAAAPAFAAVSVAAAALGGYLFC,30,26.510965,27,3
E0D877,MAGKPGIQLFVIFLLLSSFAAVVWAMDNMPADKDVSKLFPLTLIHINDLHARFDETNMKSNACTAKDQCI,25,22.895405,23,2
B1P0S1,MALSLFTVGQFIFLFWTISITEANIDPAARAAAAAAASKAAVTAADAAAAAATIAASAASVAAATAADDA,23,21.324322,21,2
Q9U943,MGTPPHIWFLLILAISSGGLSAAVGGCNHQCTPQSSVFQYQKGQTYTYSFEGTTLTSLPGTQGEPVRLKL,21,21.503935,22,1
Q9V496,MARMKYNIALIGILASVLLTIAVNAENACNLGCPKSDNGLLKYIPGNYYDYSFDSILTIGASSDVPNDSD,25,26.521278,27,2
Q2A783,MKVFILALLALTATTAIAQLETTCSQGFGQYQQQQQPGQRQLLEQMKPCVAFLQQQCRPLRMPFLQTQVE,18,17.456982,17,1
Q9NR16,MMLPQNSWHIDFGRCCCHQNLFSAVVTCILLLNSCFLISSFNGTDLELRLVNGDGPCSGTVEVKFQGQWG,40,36.693443,37,3
Q9BXJ3,MLPLLLGLLGPAACWALGPTPGPGSSELRSAFSAARTTPLEGTSEMAVTFDKVYVNIGGDFDVATGQFRC,16,17.421581,17,1
D4A540,MGTSSARPAVLALAGLALLLLLCLGPGDVSGNKLKKMLQKREGPVPSKTNVAVSEHTAKEFLGGLKRAKR,31,24.679749,25,6
Q9BWV1,MLRGTMTAWRGMRPEVTLACLLLATAGCFADLNEVPQVTVQPASTVQKPGGTVILGCVVEPPRMNVTWRL,30,28.232788,28,2
Q9LRC8,MGFQVWQKGLCVLCFSLIFICGVIGEETTIVKIEENPVAQTDENYVCATLDLWPPTKCNYGNCPWGKSSF,25,22.271423,22,3
P13806,MAAGRPLAWTLTLWQAWLILIGPSSEEPFPSAVTIKSWVDKMQEDLVTLAKTASGVHQLVDIYEKYQDLY,26,22.641136,23,3
A3RF67,MHAMTFKAILLLGLLALVSTSASIAFAKEVRATITEVPPFNRNSFPSDFIFGTAASSYQYEGEGRVPSIW,31,21.45418,21,10
B8JLQ9,MMQASITSILVVLTLVAQDRLAGGLEHKSYDYTKYHTMDEISAWMNQMQRENPDVVSTMTYGQTYEKRNI,24,22.037582,22,2
Q76FB0,MFVKMIGWLVLFLFAHQTWAIEVAKDTNGGILNIAPEQLKRGKRLFNSHCSSCHVGGITKTNPNIGLDLE,20,19.18997,19,1
Q94K85,MAVYNTKLCLASVFLLLGLLLAFDLKGIEAESLTKQKLDSKILQDEIVKKVNENPNAGWKAAINDRFSNA,26,22.804642,23,3
Q07092,MWVSWAPGLWLLGLWATFGHGANTGAQCPPSQQEGLKLEHSSSLPANVTGFNLIHRLSLMKTSAIKKIRN,21,21.285603,21,0
W1I921,MATFQAHFFAAVMCVGVLGLSKLCGADSCEYPDCVFTGLPRSSGVERYILLLNIIEVPDDIQQQCDILIQ,26,24.073961,24,2
Q9NZV1,MYLVAGDRGLAGCGHLLVSLLGLLLLLARSGTRALVCLPCDESKCEEPRNCPGSIVQGVCGCCYTCASQR,34,30.453768,30,4
Q8SXL2,MKSTISLLLVVICTVVLAAQQSQAKKGCQAYGHVCYGGHGKRSLSPGSGSGTGVGGGMGEAASGGQEPDY,24,19.761929,20,4
P14661,MFLIYLFVQTAESSWLSKTAKKLENSAKKRISEGIAIAIQGGPRRRRFVAEQDAIHSRVSREVPTLSDSV,13,15.544657,16,3
Q8J0D2,MVAVTSLGKALTALSILASLAVAKEHYEFKNVAIGGGGYITGIVAHPKTKDLLYARTDIGGAYRWDAGTS,23,24.673748,25,2
A6P6V9,MKCSTFSFWFVCKIIFFFFSFNIQTSIANPRENFLKCFSQYIPNNATNLKLVYTQNNPLYMSVLNSTIHN,28,22.264526,22,6
Q8IVL8,MKPLLETLYLLGMLVPGGLGYDRSLAQHRQEIVDKSVSPWSLETYSYNIYHPMGEIYEWMREISEKYKEV,20,20.028837,20,0
A0A0F7YZQ7,MAPSQKALLVLVLSMLLTASDSWARRIDCKVFVFAPICRGVAAKRGGDSLSVGGSAELDDALTDPFLRSE,24,23.132729,23,1
Q8WUJ3,MGAAGRQDFLFKAMLTISWLTLTCFPGATSTVAAGCPDQSPELQPWNPGHDQDHHVHIGQGKTLLLTSSA,30,31.38736,31,1
Q6QD51,MTWKMGPHFTMLLAMWLVCGSASQSSALDSDGRPGRKVPLASPISSRSARYLRHTGRSGGVEKSTQEEPN,27,21.834574,22,5
Q4V4I9,MWYSKCSWTLVVLVALFALVTGSCLEYGHSCWGAHGKRSGGKAVIDAKQHPLPNSYGLDSVVEQLYNNNN,22,24.829521,25,3
Q28085,MRFPAKIVWLVLWTVCVAEDCKEPPPRKETEILSGSWTEQTYQEGTQATYKCRPGYRTLGSIVMMCRGGK,18,19.488184,19,1
Q9D6Y1,MPLPLLLAALCLAASPAPARACQLPSEWRPLSEGCRAELAETIVYAKVLALHPEVPGLYNYLPWQYQAGE,21,18.981186,19,2
P00450,MKILILGIFLFLCSTPAWAKEKHYYIGIIETTWDYASDHGEKKLISVDTEHSNIYLQNGPDRIGRLYKKA,19,16.734837,17,2
Q27081,MTWICVITLFALASATLGNKVSRVGVLFPKTRNDNECTARGGLKGSCKSLIDCPSVLATLKDSFPVVCSW,23,18.431698,18,5
O75596,MAKNGLVICILVITLLLDQTTSHTSRLKARKHSKRRVRDKDGDLKTQIEKLWTEVNALKEIQALQTVCLR,22,21.345556,21,1
Q02246,MGTATRRKPHLLLVAAVALVSSSAWSSALGSQTTFGPVFEDQPLSVLFPEESTEEQVLLACRARASPPAT,30,27.539492,28,2
P02466,MLSFVDTRTLLLLAVTSCLATCQSLQMGSVRKGPTGDRGPRGQRGPAGPRGRDGVDGPVGPPGPPGAPGP,22,21.522366,22,0
P02462,MGPRLSVWLLLLPAALLLHEEHSRAAAKGGCAGSGCGKCDCHGVKGQKGERGLPGLQGVIGFPGMQGPEG,27,22.764662,23,4
Q6UWK7,MRLLVLSSLLCILLLCFSIFSTEGKRRPAKAWSGRRTRLCCHRVPSPNSTNLKGHHVRLCKPCKLEPEPR,24,18.253078,18,6
P12024,MGLEFFFKFGYAFLTITLMIMIWMSLARASMFDREMEETHYPPCTYNVMCTCSKSSTDLGIVHCKNVPFP,29,30.7233,31,2
Q9U572,MKALILLLLGACQALQPGLEYQYRYSARVASGIPSINRQFAAAGIQADVTVQMAADYSVVVQFSNIEVGD,14,15.637895,16,2
P13611,MFINIKSILWMCSTLIVTHALHKVKVGKSPPVRGSLSGKVSLPCHFSTMPTLPPSYNTSEFLRIKWSKIE,20,20.236897,20,0
P86798,MKHLIPLIVMASVVLAVYADRGYGGGRRGGGYGGGGYGGGGYGGGGGGYGGGVGGGRGGGGGLGGGRGGG,19,19.298883,19,0
A0A0F7YYX3,MSSPLRMDVTFLLAAIAVTWVCGLKIGFPGFSTPPRSFIQHPKRTLCPEDCDIASPFKCEESPTCLRLFQ,25,22.059233,22,3
Q00657,MLLSPGHPLSAPALALILTLALLVRSTAPASFFGENHLEVPVPSALTRVDLLLQFSTSQPEALLLLAAGQ,29,24.305847,24,5
Q875I9,MRLSEILTVALVTGATAYNLPNNLKQIYDKHKGKCSKVLAKGFTNGDASQGKSFSYCGDIPGAIFISSSK,17,19.421764,19,2
P69770,MFGHTSVSFLLLSIVALGMVATVICSCDSEFSSEFCEQPEERICSCSTHVCCHLSSSKRDQCMTWNRCLS,25,21.722569,22,3
Q6T6T4,MHSRLLVAAPHCLLLLLLLPSALPALKVGGLYPRDVMDPEVQEAAAFAVENYNAQSTNDNYFKARRIVEA,26,21.343452,21,5
B8AL97,MAKKKTSSSMARSQLAALLISLCFLSLASNAVGWSRRGEREEEDERRRHGGEGGRPYHFGEESFRHWTRT,34,32.42376,32,2
Q9SUQ8,MAFLVEKQLFKALFSFFLLVLLFSDTVLSFRKTIDQKKPCKHFSFYFHDILYDGDNVANATSAAIVSPPG,29,25.24644,25,4
G9M8X1,MMRAIYLLVVVCWAAAANASSDTVPAEVQTIVKTPGHQYDLYKKMVATISLPANANTEIHKGLNIKRPDN,19,18.748142,19,0
F7J1C8,MKLFVVLACLAAPGTFPFVDAATVIPANSFSSFSTYWNNFYPWGTDHNGSGRMASANIIVASNTLSLIAT,21,16.312727,16,5
F1N5C8,MAGKLGVLLLALVLSLAQPASARRKLLVFLLDGFRADYISDEALESLPGFKEIVSRGVKVDYLTPDFPTL,22,21.62651,22,0
O15197,MATEGAAQLGNRVAGMVCSLWVLLLVSSVLALEEVLLDTTGETSEIGWLTYPPGGWDEVSVLDDQRRLTR,31,32.742474,33,2
Q5JNJ5,MEASRRWPYAAWFMAVLGLVAVFSSSEAYVFYAGGRDGWVVDPAESFNYWAERNRFQVNDTIVFLHDDEV,28,26.392448,26,2
O97939,MLLSCRHGASSPKLDNLVPSGKMKILLVFLGLLCYSAAMPMQMPRMPGFSSKSEEMMRYGHFNFMNAPHM,38,35.954605,36,2
Q9GU69,MMRHLLLVGAAILIFVSDAQAQGDGEDPCQIVRCSYGANCIAYGDTAICECPFGYSGIRCQDPS,21,19.40196,19,2
Q99372,MAGLTAAVPQPGVLLILLLNLLHPAQPGGVPGAVPGGVPGGLPGGVPGGVYYPGAGIGGGLGGGALGPGG,27,28.666252,29,2
Q9Y6C2,MAPRTLWSCYLCCLLTAAAGAASYPPRGFSLYTGSSGALSPGGPQAQIAPRPASRHRNWCAYVVTRTVSC,21,21.336617,21,0
Q7SZN0,MGRYSVSPVPKCLLLMFLGWSGLKYYQVNAAQLREYHIAAQLEDWDYNPQPEELSRLSESDLTFKKIVYR,30,26.147297,26,4
P35555,MRRGRLLEIALGFTVLLASYTSHGADANLEAGNVKETRASRAKRRGGGGHDALKGPNVCGSRYNAYCCPG,24,22.531605,23,1
Q8TAL6,MVFLKFFCMSFFCHLCQGYFDGPLYPEMSNGTLHHYFVPDGDYEENDDPEKCQLLFRVSDHRRCSQGEGS,18,16.463842,16,2
P37889,MLLQESAGVWLALALVTALTPSPSMAVPWQDCTGAECPLLENCIEEALEPGACCATCVQQGCACEGYQYY,26,22.830364,23,3
P04937,MLRGPGPGRLLLLAVLCLGTSVRCTETGKSKRQAQQIVQPPSPVAVSQSKPGCFDNGKHYQINQQWERTY,24,23.990887,24,0
P05790,MRVKTFVILCCALQYVAYTNANINDFDEDYFGSDVTVQSSNTTDEIIRDASGAVIEEQITTKKMQRKNKN,21,18.504854,19,2
P86875,MLLVTLFLFFLQALVNGDSCGSNCEKSERPKRVFNIYWNVPTFMCHQYGLYFDEVTNFNIKHNSKDNFQG,26,17.157564,17,9
Q60767,MRTGRVTPGLAAGLLLLLLRSFGLVEPSESSGNDPFTIVHENTGKCIQPLSDWVVAQDCSGTNNMLWKWV,27,25.292171,25,2
P00719,MHLMLVLLGLAALLGTSQSRTGCYGDVNRVDTTGASCKSAKPEKLNYCGVAASRKIAERDLQSMDRYKAL,19,16.82866,17,2
P16636,MRFAWTVLFLGQLQFCPLLRCAPQAPREPPAAPGAWRQTIQWENNGQVFSLLSLGAQYQPQRRRDSSATA,21,18.407776,18,3
O35806,MRAPTTVRCSGRIQRARWRGFLPLVLALLMGTSHAQRDSVGRYEPASRDANRLWRPVGNHPAAAAAKVYS,35,35.38715,35,0
P48765,MLQFSLSPTLSMGFHVIAMVALLFSHVDHISAETEMEGEGNETGECTGSYYCKKGVILPIWEPQDPSFGD,32,26.36692,26,6
P15941,MTPGTQSPFFLLLLLTVLTVVTGSGHASSTPGGEKETSATQRSSVPSSTEKNAVSMTSSVLSSHSPGSGS,23,24.348621,24,1
Q99972,MRFFCARCCSFGPEMPAVQLLLLACLVWDVGARTAQLRKANDQSGRCQYTFSVASPNESSCPEQSQAMSV,32,30.791859,31,1
P24330,MKILYLLFAFLFLAFLSEPGNAYKRCHKKGGHCFPKTVICLPPSSDFGKMDCRWRWKCCKKGSVNNAISI,22,19.115309,19,3
Q02083,MRTADREARPGLPSLLLLLLAGAGLSAASPPAAPRFNVSLDSVPELRWLPVLRHYDLDLVRAAMAQVIGD,28,28.212963,28,0
Q9N4D8,MKLVILLSFVATVAVFAAPSAPAGLEEKLRALQEQLYSLEKENGVDVKQKEQPAAADTFLGFVPQKRMVA,17,17.7474,18,1
Q07310,MSFTLHSVFFTLKVSSFLGSLVGLCLGLEFMGLPNQWARYLRWDASTRSDLSFQFKTNVSTGLLLYLDDG,27,25.912304,26,1
P20241,MWRQSTILAALLVALLCAGSAESKGNRPPRITKQPAPGELLFKVAQQNKESDNPFIIECEADGQPEPEYS,23,20.146603,20,3
F1NSM7,MRATLFCLCLCLLGTVLPTPVSLPARARGNCPGQHQILLKGCNTKHGFYIFQYIYSHLMQKNQTQVKKEE,18,17.56366,18,0
P0DKU2,MVDLARRCSGSTEGRFLMWECTKWCGPGNNAKCESDLGPLEADKCCRTHDHCDYIASGETKYGITNYAFF,15,-0.6805283,-1,16
P20740,MHCFLGREILSFFCLTVRKMWLKFILAILLLHAAAGKEPEPQYVLMVPAVLQSDSPSQVCLQFFNLNQTI,36,33.54103,34,2
P0C8G7,MVKKIHFIMERHASIVAFLLAVLALTESQAFTSVKLPRDEHWPYNYVSIGPAGVWAVNRQNKLFYRTGTY,30,27.576206,28,2
P36897,MEAAVAAPRPRLLLLVLAAAAAAAAALLPGATALQCFCHLCTKDNFTCVTDGLCFVSVTETTDKVIHNSM,33,25.822468,26,7
Q9VMD9,MRALGGITLLLAVAICQGYETYQRSSFRSSSSSSYGGGQTVPQLNSFASAHFNEVRELANQLKQKFNVLS,18,17.651855,18,0
P24821,MGAMTQLLAGVFLAFLALATEGGVLKKVIRHKRQSGVNATLPEENQPVVFNHVYNIKLPVGSQCSVDLES,22,21.534203,22,0
Q2PGV8,MHFSTITAALALLGLGAATPTDYSTSSYSKNQGLAQAWTSKGRQYIGTALTIRDDPVEQGIIQSRTDFNS,26,19.94035,20,6
Q99MA2,MAQAYWQCYPWLVLLCACAWSYPGPESLGREDVRDCSTNPPRLPVTAVNTTMRLAALRQQMEKSNLSAYI,22,19.673195,20,2
Q59Y31,MKVSTIFAAASALFAATTTLAQDVACLVDNQQVAVVDLDTGVCPFTIPASLAAFFTFVSLEEYNVQFYYT,21,20.482956,20,1
P79762,MQGGRVVLGLLCCLVAGVGSYTPWDISWAARGDPSAWSWGAEAHSRAVAGSHPVAVQCQEAQLVVTVHRD,20,20.539768,21,1
P40881,MMFNKQIFTILILSLSLALAGSGCISEGAEDNVAQEITVDEFSNIRENPVTPWNPEPSAPVIDPTAYIDP,34,22.403915,22,12
Q58232,MAMSLKKIGAIAVGGAMVATALASGVAAEVTTSGFSDYKELKDILVKDGQPNCYVVVGADAPSTMDVVSA,28,25.16315,25,3
P27373,MRKFTLLMLLLIVISMSGIAGAAEVKNLNTSKTFTKIQEAIDDPSTTDGNIIIVGPGNYTENILVNKSLT,22,18.666372,19,3
P25062,MTKLKDQTRAILLATLMVTSVFAGAIAFTGSAAAERGNLDADSESFNKTIQSGDRVFLGEEISTDAGLGA,34,26.411037,26,8
Q9C4B4,MTDTQQKIKAVLLTVLMVTSVFAATIAFSGAAAASERGAGDSYTTGPTDGNQDNVDSAGNVGAGAVVFQG,34,28.504381,29,5
B0R8E4,MTDTTGKLRAVLLTALMVGSVIGAGVAFTGGAAAANASDLNDYQRFNENTNYTYSTASEDGKTEGSVASG,34,25.951967,26,8
Q50833,MKKIGAIAAGSAMVASALATGVFAVEKIGDVEGFKVIDNGEPTADIVVGSTAAAADVVSAANVAAKVGSM,24,21.646107,22,2
Q12VE2,MKGFIAIAIAALMVLSFVSVASAADTIEIRSPVMAGNLAGERDLSNVTLNSTTFTDFAAFFYDIDDGIGS,23,19.909443,20,3
Q12UJ4,MKNKTLSKTFVVLLSLLMILSISSAGANVVEQGIAVENPSGPVMNSVMSVASTSLAPVVTETGKISLSID,27,26.230045,26,1
Q12WA9,MKNMTKMTLSILIIGIIGIMLTGFAWAESSDSSQDEAFEEEYYFPEYESTTLESLKKSSDVIETRGTVPI,27,24.778124,25,2
Q12WY2,MQKSKTTTVIAIMLLILVAFVPMVSAQEETLPDSSSNKQVTIELNQKDGVLIIPTEDKKITDLSTTATTE,26,23.298355,23,3
Q12WZ0,MKTNRKFGIGAMLAAMLLISMAFVPAVSAGQDKISEENIKESQMLQYIDIEELYTEVNSYIEKNPDATDK,29,24.044765,24,5
Q12UD6,MKTKGIRMAALFMAMLVVSMFAVAPAMACAPQEPIDKSDEKKVLKVVSDEISLPEEYTISNNPDTDGFIF,28,13.20423,13,15
Q12X64,MLKMNRNEDAVSPVIGVILMVAITVILAAVIAAFVFGMGAPETAPQASVRGAPAELGGNNVLKLEHQGGD,37,32.091896,32,5
Q980C6,MVVKKTFVLSTLILISVVALVSTAVYTSGNVTFYSPSVNNQIYYVGKSVTIDAVVPQQFAGQGAVINLFF,24,21.932537,22,2
Q97UG7,MNKKIKNVIGLTALILMALSAFMPFIISSRVVNSQSPQLNPAASYSFPWASSYPTFGVTTGSGPIVPNNW,34,25.238134,25,9
Q97VF7,MRKELVLEVGVIFSISVMLFSISGIMIANSASSPFPSTLYLGWYNSNVEAYSSFATYNPNIFAGGLGGSF,30,22.60286,23,7
Q97UH5,MKRYKIISTIITVLMVISIGIFAMPILSQSTSVQPEGSMVIMPSPGIVWQDNFNPWNAPALPGGLIWLIY,28,23.49107,23,5
Q6M088,MAMSMKKIGAIAVGGAMVASALATGAFAAEKVGDVDAFAADVVADGNANVDIVVGSNAAALDVVSAANVA,28,25.63647,26,2
P17118,MNFKSICLIILLSALIIPYIPQNIYFFPHRNTTGATISSGLYVNPYLYYTSPPAPAGIASFGLYNYSGNV,34,20.414164,20,14
P72186,MNKKGLTVLFIAIMLLSVVPVHFVSAGTPPVSSENSTTSILPNQQVVTKEVSQAALNAIMKGQPNMVLII,26,22.807678,23,3
Q97Z97,MKYGNMKKWAPLILFLFSLLLLQGISLHASSPSFSVNASYLASLPYANSHVAVVYYQGSLYIIGGDSHSN,31,26.324394,26,5
Q58368,MKKFILFLIILLFSIYFLNVSSAEVCPFKDGFIIIYHDIGYDKLFGYTYNDSEILYFNNKNLMDITPISD,23,18.52998,19,4
Q973G3,MKRNTLLALVLVILIFPTLSTAYIEFTTSINQAIPDSLVYATSAYYDGKIFLIGGENLYSTPVNSVYVYE,22,20.040495,20,2
Q9UYS2,MSRSFMIILTIMLIALSLGEVLAAENGYDLIIVRNDDLIDYLIALPYSHLLDIPILPVNPKELDDVTKAQ,23,20.15043,20,3
P58502,MKKSIALVLSIVLLAALFAVPASAGEQNTIRVIVSVDKAKFNPHEVLGIGGHIVYQFKLIPAVVVDVPAN,24,20.410297,20,4
Q9UWR7,MKKIWTSIVLTAVLLLSLVQVGTFPWASAAESVSLSGSAIAWDVVNLTWSPYSSAKAYEVYRSTDPSNLF,29,21.639923,22,7
O58925,MEGNTILKIVLICTILAGLFGQVVPVYAENTTYQTPTGIYYEVRGDTIYMINVTSGEETPIHLFGVNWFG,28,23.012518,23,5
Q97VC2,MKALSTLAMAVIIIVVIAVVAAAAYLITSSSHHPSISTTTTPIIATNTTAPITLTVVTFSGQSANFIQYA,24,20.206722,20,4
Q9YBL5,MRTSLARILIAAVMIAIFILPSIPLVTLASAQAGQPVETITFKTVTDMTADIVEVGSGNADIFLWSQPLK,31,24.517685,25,6
Q9HHB0,MGWRPVAVYATLILVLLQLTPLPIAGASIMEIYVADDQVTVVHNPLDPAYLSAADGYLIPRIRVASSLDV,27,22.487253,22,5
Q48929,MVNIDKKIVIIVGIVILIAVVAGAFLVTGTASADNKVRVGYLPSTGDSLYFIAKEKGYFADEGLDVQLNE,33,24.798655,25,8
Q9HQ20,MHRGRFATLVIVALAVTMTAPAGALAPQPPAQHADADRACSFPVTEPDASNTAITLDSEPERVVTLNPSA,24,21.150011,21,3
Q97VS7,MNKLIPIFVVVIIVLGIIVSIEFGKFHQNASLTRSTERFTLFPAHNRPFSVLGNYSSNSADALAILNSST,20,20.94168,21,1
Q9Y9Y8,MESMGKAGLKRFLPLLTTAGLLLALALAFAATYAKAQETVETTTTTAGEQPVPGKADFESLVKECKAYEK,30,32.18572,32,2
Q8U0C9,MKGLKALILVILVLGLVVGSVAAAPEKKVEQVRNVEKNYGLLTPGLFRKIQKLNPNEEISTVIVFENHRE,23,19.991499,20,3
Q8U1U6,MRRNAQVFAMVLLLVLSGIPKALALYTPTPFSIDGNLEEWIKADAIAYGRDSGLPGANLDKLYIAWDDNY,24,19.639854,20,4
Q6L252,MRKGTILKIIAILAVLIMVSSVTLFSYGHENSYKSSVVPVKKNIYFTGNLSRDFDGNIIGINNHASPWGA,21,24.348888,24,3
Q9Y8I8,MRRVVALFIAILMLGSIVGANVKSVGAAEPKPLNVIIVWHQHQPYYYDPVQDVYTRPWVRLHAANNYWKM,27,19.611015,20,7
O08452,MNIKKLTPLLTLLLFFIVLASPVSAAKYLELEEGGVIMQAFYWDVPGGGIWWDHIRSKIPEWYEAGISAI,26,23.694004,24,2
O93635,MNRRVLSLLIVAVMLLSAIPAAVSVPAVTATPVQPTDIPQQVAVEKPSNFIPGEVLQKEIQKVLEISGKT,27,18.289738,18,9
Q9YFI3,MGTKIAAIAIALIFILPLFPVYTGSAAGASTVVIAKINPEEFNPKAVEALQGKVIYVADLAPVAIISIPG,27,21.813805,22,5
Q5JGP8,MNRKVLSLLIVAVMVLSVVPAVLPGTLAAQNSPENHSVIRTLEDTLDKSLLLSSYKTGLRWVSPEEYSKI,28,20.606794,21,7
Q9V2T0,MSKKKFVIVSILTILLVQAIYFVEKYHTSEDKSTSNTSSTPPQTTLSTTKVLKIRYPDDGEWPGAPIDKD,19,20.737934,21,2
A8ABZ0,MEAREVEEMRRSRLLTLGGIGYTAVIALAALVLVMGALGLVLKVAAAAGALPSEVAKVANALPGLKASVD,-1,-0.6651212,-1,0
G8YXZ9,MNLKILVGLFILGIIILSAMTFLNFTTIVAQDKGDQQPKGPIVYTYTEYNGTYFPHILTVVYYPCNATCS,39,21.80785,22,17
B1GT61,MDLSTKKVISAGLVFIYALSLAMLVPMFLASNQGVISAVINPATGGNCLPGRYSGIVQASGVTLPAVNLS,30,28.158224,28,2
Q980C7,MNKTLGLILTSVFLLSTLGIITGFVIPTQAANSNDAAIYTIPSVTSVSNTSNIVINLFFNATSNSTVGAQ,31,20.395708,20,11
A6URZ5,MAMSMKKIGAIAVGGAMVASALATGALAAEKVGDVDAFAANAVTNGNVNVDIVVGSNAAAKDVVSAANIA,28,25.436178,25,3
Q46BP2,MKRFAAVTLAALMLLTVFASAASAADSVEIRGPVFNGSNIVEIVGDGITIDATQFAAFYYDIDDNVTTET,24,21.32275,21,3
Q48236,MSKDRDGRRTSRRGTLKKIGGFSLGALSFGAVGRTQAATGSSVTTADIAPPGPNGDPKSVQIDDKYTGAE,-1,-0.76016915,-1,0
O29751,MMSRRKFLLLTGAAAAGAILTPQISAKTQFIESPEEVREKRRWAMAVDVERCTQCMEELIAKTGDEKIKP,-1,-0.7395693,-1,0
Q60224,MRRNHSHTSDSAGIDRRTVLRSSAAAGALALTGVTIGSTSAAARSEGATAPNDGVGYQYFHREWTEIEAD,-1,-0.768673,-1,0
Q97V37,MLKLSRRDFLKISGATAVATAFILGGNSVAKRIFDSVSETNYTLNYPSDEIVYTNCFQCLGRCAIEVVRT,-1,-0.808217,-1,0
P29143,MSRDTKRNIGRRSVLKATSALGAFLGLGGVTSATPGRSRSRKKDEIVVGVSDSVSASKATIDSKLPSKAT,-1,-0.78749835,-1,0
Q4A3E0,MNRPRITGSKQASRRTVLKGIGVLGAAVFGTAASVGSSAAVGDSAVYQYYHTDWTEITATLETVAQQGYD,-1,-0.67232144,-1,0
P83716,MKEDNNTSEESGRINRRNVLKTVGAAGLFAAGSTGMAAAADSLSQAEEPKLLTGTEKRTLARELAKTPAF,-1,-0.6365961,-1,0
Q5V573,MRPTDLPEIDTTAQNRRTFMQRTGGVSLAAVLGLSKGASAMVDDDGNFESDPYTLGIASGDPLPDSVIIW,-1,-0.73695993,-1,0
Q97UF5,MSRRRLYKAISRTAIIIIVVVIIIAAIAGGLAAYYSSSKPPATSTSLTSTSSSLSVTTSSTTSTLSSITT,-1,18.596289,19,20
Q9HSH6,MPSRRDVLRLGAGVLAAGTAGCTDTAPNRVAAAETAATTTRETTTDSRSESPYTAVYRDVIDSVVMIRTQ,-1,-0.7958567,-1,0
D4GPN3,MSERNSSRQHSRRKYLAALGAAGVAAVGSTGVIAGRGRDDEQTDVEGTLYSPPSGAPAPGSLYPRVTRLK,-1,-0.70637256,-1,0
D4GPW9,MRPDRRTFLRVLGAGSIGAATTGLFGGSAAAATVISMQGGGDDIWGTADAFHYYYTELSGDFDVAVQNTG,-1,-0.7730249,-1,0
D4GUI7,MKRREFLRTAGGATAAATAAAGTAAAQEGGGGAQVQPDFGGYLDGVDGGYEDLRGQSEVTIEVGASGNGG,-1,-0.6595353,-1,0
O30078,MQLSRRDFIKGLVAVGSASVFLAGYSETVDRLVKPRYTEVKPDSVGRIVHSACLGCNVRCGIRVNVVQRG,-1,-0.75878704,-1,0
Q9HHA8,MSDKDSINRRNVLRKIGGIGVASAVGFSGLASGESLSDDEKQDVIDTIYKSQRVEQIKKKFGGVNIEPKK,-1,-0.7718629,-1,0
D4GPK6,MTDWSRRRFLQTGAALGIAGTLPQTTTEVSAASPTLEKFVQPLPIPSVREPDGQRDGADAYEIAVTEFTQ,-1,-0.76841015,-1,0
D4GQ16,MNPDSAAGRSSRRAFLAAVGGVAAGGLTATAGCLGRGEEAPTVSILAAGSLQRALTTEFDAPDGTRIEVE,-1,-0.77600235,-1,0
Q9HPK2,MTGTAPVSRRQYLGTAGAIIGTTAGCLTGADASIHVLAAGSLTSTIEDHIRPAFEDATDHTLRPEYHGST,-1,-0.44360766,0,1
D4GSY9,MAIERRRFLQAAGVGAVLGLSGCTGNTSPPQANNETAEGSGGSESGDGSTQELTLATTTSTYDTGLLDAL,-1,-0.8045212,-1,0
B0R6I5,MHSTTRREWLGAIGATAATGLAGCAGVGGAGQPVTVGSLLPLSGPGSLGALAADHQRAIDTAVEHANRGG,-1,-0.7981371,-1,0
Q9HR74,MSDTDLNATRRDVLKSGAVAAVGLSGGGLLSTLQEADDSDTAGDAVTSFLGEDQVVKTACSPNCRGKCPL,-1,-0.7508564,-1,0
D4H031,MDRRQFLRTVGASALAVSTAAVVGSRPATAHPGPFEPLGRIDIDGAKEAVVSADGETVFVAATSGYAVVD,-1,-0.7096044,-1,0
P39442,MKDISRRRFVLGTGATVAAATLAGCNGNGNGNGNGNGNGEPDTPEGRADQFLTDNDALMYDGDITDETGQ,-1,-0.81612855,-1,0
P58300,MRRATYAFALLAILVLGVVASGCIGGGTTTPTQTSPATQPTTTQTPTQTETQAVECGSGKVVIWHAMQPN,-1,-0.598884,-1,0
Q7LYW7,MNVKKVLLGLFLVGVLGIAVVASGCIGGQQTSTVTSTPTETSLQGKIVFAVGGAPNEIEYWKGVIAEFEK,-1,-0.25391248,0,1
Q58586,MIKRLIVISILLIVGTVLCGCMEQENVGQQNSEAQEKIVLKIFHAGSLSVPFEEYEKMFEKEHPNVDVER,-1,-0.74278545,-1,0
O58758,MRYAMNKIPALLLVGALIIATVASGCIGGTTTTETPTVTKTKTQEVITLKVIGPWSGAELDAFMEVLKAF,-1,-0.52446187,-1,0
Q9UZJ3,MRYLVPLLVFMVLGMGCLGGGGEEMVKVSSVFGNDEFIPAKYTCEGIDVNPPLRIEGISENAKSLVIIVD,-1,-0.5941124,-1,0
O29850,MNRIVGILISILMLACIGVTMAAETPVEATIEPKNTFSEPLATQMVLLKGIFDPKVEPMDPANDAIEITG,-1,18.19474,18,19
Q58949,MKIKAVAIFLSLLMIISLFSGCVENEKPIKEGSNDFKLIPVNSKSNFEEFKNTVENSIGNYIYVGHSYAS,-1,-0.56893265,-1,0
Q8U0A4,MRKVGITLSVVALVIMGFVAGCIGGTQTQGEKVKVAVLFDVGGRGDLSFNDMAYLGAERAKKELGVEVEY,-1,-0.6252616,-1,0
C7NWW8,MCPRPRRAVLLGLGVAMSAIAGCRETAPSTTQTSDGGPEPTGRSGDTQTDGGGETTRQATVAEGGESATR,-1,-0.82060444,-1,0
O28285,MKGGDKMKKLILLMLLLPISLIGCTDEESSVTVGHTTVYYTNVPDAKAEVLAGYLQEEFGFTSDTDILLS,-1,-0.7168587,-1,0
Q9V297,MKRGIYAVLLVGVLIFSVVASGCIGGTQTQTETQTPEKTQTPTTTQPSPTTTTSPTQTTSQTPTETETHT,-1,-0.616572,-1,0
O28918,MHLTIMRRFAVLLLLAIFLGGCSGSNGAAEEKWKMKVIWHVDTSGEPFMDLSPDGELAAAVDWNNAKIYL,-1,-0.76709247,-1,0
O29261,MRKFVAFFVIVALAALLAGCGGQGEQEQKPSEQKTTTTVAESKGIETLSDLYNSKKMVHGTAKVTLQGET,-1,-0.6060815,-1,0
O58969,MSRKYLLSLLLVGALVISVVASGCIGGSQTPTSSPTKTQQVQELEIYHWWTAGGEKEAFDALAKKFEKKY,-1,-0.3302916,0,1
Q57550,MLKKLIGLLTILIIAVGFCGCMEQNIEKQTPTASEAPNTIKVVDLYGREVEVPKEVNRIVCCGPGCLRLI,-1,-0.7280652,-1,0
Q58282,MRKLFLLSILMIGVIVAFAGCVEESKTTTQLQQTTQSESQKAETQPKLGVNVVRYAETFKLYPHWDEGYC,-1,-0.68043983,-1,0
O30316,MKVLSISLIFFALLLTGCSQVEKIAPDNFNKIFEEGKQFVENTQTEIEDIDIEQLIEKAKELGFNTEILT,-1,-0.5181414,-1,0
Q58288,MKKLLAIGILCIMVTAVMSGCVSEKEININNSNKITTNMPVSEKNITKILKYAKNMNLIYYDENGNIVNP,-1,-0.5423698,-1,0
A0P8X0,MTRKTRYLHQITTLILGGLLIVPAAAPPVSADIAATHVYHNHMPNFWAYYDLNTYNSTPVGSPIRYTYDG,31,27.552574,28,3
P16950,MFKRRALGFLLAFLLVFTAVFGSMPMEFAKAETDTAPAIANVVGNFQSKLGDSDWNINSDKTIMTYKGNG,31,18.732197,19,12
P17953,MKQQTEVKKRFKMYKAKKHWVVAPILFIGVLGVVGLATDDVQAAELDTQPGTTTVQPDNPDPQVGSTTPK,43,35.239277,35,8
P27951,MFKSNYERKMRYSIRKFSVGVASVAVASLFMGSVAHASELVKDDSVKTTEVAAKPYPSMAQTDQGNNSSS,37,33.368523,33,4
P15926,MRKKQKLPFDKLAIALMSTSILLNAQSDIKANTVTEDTPVTEQAVETPQPTAVSEEVPSSKETKTPQTPD,31,27.282902,27,4
P14529,MGKLRKNLLAWAGTGVAAACAVTMTAVPALSTPEPEAAGVVSASPYLYNGWGNPPSPTEVMNASGIKNFT,35,20.470436,20,15
Q06851,MRKVISMLLVVAMLTTIFAAMIPQTVSAATMTVEIGKVTAAVGSKVEIPITLKGVPSKGMANCDFVLGYD,28,20.097296,20,8
P84908,MKRMGWAVTAAVTTIVLAQSSLAAQAADSTSGWRAPSCTKVTGDGAVTFTTDDGATLAPTTGTLQSVSYT,26,24.190315,24,2
P39653,MNNRMLSFPSMLFLLAFGIVLSVSAGTTHADELANQTAKVADEASIVVSTSQAAVEQTQSQEKEISPAME,30,22.935982,23,7
O82833,MRFSWKKLVSAALVMALLVGIVYPAASGRGAVASAASGTTVELVPTDDAFTSAVAKDANANGTWMQLKGS,35,26.943096,27,8
P04067,MFTPVRRRVRTAALALSAAAALVLGSTAASGASATPSPAPAPAPAPVKQGPTSVAYVEVNNNSMLNVGKY,42,28.473612,28,14
Q6RUF5,MGGVTMKNNLKKYIKYILSVILVFFVGVNGMEVYALEESRDVYLSDLDWLNATHGDDTKSKIVQKNHPFT,35,33.40355,33,2
P94522,MKKKKTWKRFLHFSSAALAAGLIFTSAAPAEAAFWGASNELLHDPTMIKEGSSWYALGTGLTEERGLRVL,32,29.662413,30,2
E9K9Z1,MSKLVKTLTISEISKAQNNGGKPAWCWYTLAMCGAGYDSGTCDYMYSHCFGIKHHSSGSSSYHC,21,29.866783,30,9
P14090,MVSRRSSQARGALTAVVATLALALAGSGTALAASPIGEGTFDDGPEGWVAYGTDGPLDTSTGALCVAVPA,32,29.547598,30,2
A0QR29,MKAISRVLIAMVAAIAALFTSTGTSHAGLDNELSLVDGQDRTLTVQQWDTFLNGVFPLDRNRLTREWFHS,27,20.781088,21,6
P86242,MREFRRVRRVRFAACALVAAATGITLAAGPASADIPIGQKMTGKMTYYTDKGYGACGTPIDASSQDLVAI,33,19.337315,19,14
P11657,MKVKKTYGFRKSKISKTLCGAVLGTVAAVSVAGQKVFADETTTTSDVDTKVVGTQTGNPATNLPEAQGSA,38,21.883512,22,16
O86308,MDTMTLFTTSATRSRRATASIVAGMTLAGAAAVGFSAPAQAATVDTWDRLAECESNGTWDINTGNGFYGG,41,-0.31822437,0,41
O34344,MKSKLLRLLIVSMVTILVFSLVGLSKESSTSAKENHTFSGEDYFRGLLFGQGEVGKLISNDLDPKLVKEA,32,22.947048,23,9
P38538,MQDSGFKKKDRSTNIPQEQFVYTRGGEHKVMKKVVNSVLASALAITVAPMAFAAEDTTTAPKMDAAMEKT,53,37.48594,37,16
P09333,MNKKVVLSVLSTTLVASVAASAFAAPKDGIYIGGNIKKYYSTDVLFEMTPQAKATYASELNAMASDFNNV,24,19.99633,20,4
P04189,MRSKKLWISLLFALTLIFTMAFSNMSAQAAGKSSTEKKYIVGFKQTMSAMSSAKKKDVISEKGGKVQKQF,29,22.61329,23,6
P36917,MMKNNVDRIVSIVTALIMIFGASLFSPPIRVFADDTNINLVSNGDFESGTIDGWIKQGNPTLAVTTEQAI,33,26.072971,26,7
Q9AQS0,MLSGILIAALLMTLWGGWQPDIAHASDEFDALRIKWATLLTGGPALDPADSDIAARTDKLAQDANDYWED,25,18.42197,18,7
Q46023,MNKTFKTLTLALATGSIALTLAACGNTDSATEKNANSVSASDSNAQFPITIKHAFGETTIKDAPQRIASV,-1,-0.72142375,-1,0
O05471,MKTKQVASVISLALSLFLVTGCAQLDHKANVNSKETVKQTKVTYSDEQLRSNENTMSVLWYQRAAEAKAL,-1,-0.7088527,-1,0
Q9ZEP5,MRGLTDGRTPRGTRRTTQAASTAVAVFVALGVSLAGCGTGGTGARDEGPAHADAVGGAGSASPAPAAKAS,-1,-0.7752384,-1,0
P40409,MKKISLTLLILLLALTAAACGSKNESTASKASGTASEKKKIEYLDKTYEVTVPTDKIAITGSVESMEDAK,-1,-0.46090266,0,1
P37580,MTHIYKKLGAAFFALLLIAALAACGNNSESKGSASDSKGAETFTYKAENGNVKIPKHPKRVVVMADGYYG,-1,-0.7629839,-1,0
O34335,MKHTFVLFLSLILLVLPGCSAEKSSADTAKKTLTIYSTMSTDSERDTFRKLAAAFEKEHSDIHVSLHFPG,-1,0.31335506,0,1
P24141,MKKRWSIVTLMLIFTLVLSACGFGGTGSNGEGKKDSKGKTTLNINIKTEPFSLHPGLANDSVSGGVIRQT,-1,-0.73315173,-1,0
O34966,MFKKWSGLFVIAACFLLVAACGNSSTKGSADSKGDKLHVVTTFYPMYEFTKQIVKDKGDVDLLIPSSVEP,-1,-0.73858964,-1,0
O05497,MRRILSILVFAIMLAGCSSNASTEKQHAGGEKTVKAEPQSTSSQKDSTDDYQPNSQVTDDRTLHKVGQTF,-1,-0.80484945,-1,0
O31567,MKKHISMLFVFLMAVMVLSACNSSESSSNSEVSSSKTRTVKHAMGTSDNIPANPKRIVVLTNEGTEALLA,-1,-0.7008108,-1,0
O34348,MRTYSNKLIAIMSVLLLACLIVSGCSSSQNNNGSGKSESKDSRVIHDEEGKTTVSGTPKRVVVLELSFLD,-1,-0.5536877,-1,0
P54535,MKKWLLLLVAACITFALTACGSSNSGSESGKKKLIMGTSADYKPFEYKEGDNIVGFDVELAKALAKKAGY,-1,-0.6054617,-1,0
O05410,MNILFSKRLGILTIGSLLVLAGCQTSGSSAGESNQTTSSSAVEEDSSKTQEQTSDSHTHEHSHDHSHAHD,-1,-0.7224076,-1,0
O32167,MKKLFLGALLLVFAGVMAACGSNNGAESGKKEIVVAATKTPHAEILKEAEPLLKEKGYTLKVKVLSDYKM,-1,-0.67350966,-1,0
P54941,MKKNILLVGMLVLLLMFVSACSGTASKGSSSDSASEKTEMRTYKSPKGNVNIPAHPKRIVTDFYAGELLS,-1,-0.6637707,-1,0
Q9RHZ6,MSVRRWGIVSTGVAALVLAGGAIAGCGTSNGGQNTSPSTSSSSAKGEASALPKGQTITVWSWQTGPELQD,-1,-0.7826245,-1,0
P06548,MFVLNKFFTNSHYKKIVPVVLLSCATLIGCSNSNTQSESNKQTNQTNQVKQENKRNHAFAKLEKEYNAKL,-1,-0.48622867,0,1
P00808,MKLWFSTLKLKKAAAVLLFSCVALAGCANNQTNASQPAEKNEKTEMKDDFAKLEEQFDAKLGIFALDTGT,-1,-0.6731713,-1,0
Q56247,MKWKLAAMFLGVSLALAACGGGGDNAGEKNGGSNGGGDTAAAAEQIFKQNCASCHGQDLSGGVGPNLQKV,-1,-0.71823025,-1,0
P24327,MKKIAIAAITATSILALSACSSGDKEVIAKTDAGDVTKGELYTNMKKTAGASVLTQLVQEKVLDKKYKVS,-1,-0.8016908,-1,0
P46922,MLKKIIGIGVSAMLALSLAACGSENDENASAAEQVNKTIIGIDPGSGIMSLTDKAMKDYDLNDWTLISAS,-1,-0.759144,-1,0
Q08429,MSTFETGSIVKGFYKTGVYIGEITACRPQHYLVKVKAVLTHPAQGDLHHPKQADVPFFHERKALAYGEQT,-1,0.9587264,1,2
P24011,MVKHWRLILLLALVPLLLSGCGKPFLSTLKPAGEVADKQYDLTVLSTLIMVVVVAVVSVIFFYVIVRFRR,-1,-0.48061433,0,1
P46338,MKKNKLVLMLLMAAFMMIAAACGNAGESKKSNSDSAKGEEKASGSLTISGSSAMQPLVLAAAEKFMEENP,-1,-0.70338804,-1,0
Q02VE3,MKKKMRLKVLLASTATALLLLSGCQSNQTDQTVATYSGGKVTESSFYKELKQSPTTKTMLANMLIYRALN,-1,-0.771245,-1,0
Q03490,MSASCAVPRLTRFAVFAVAGATALSLSACGSSNKSSSTSTSTSTSTSTVTSAAPSSTPNAEAKVSGLIAS,-1,-0.79100347,-1,0
P9WNF2,MINVQAKPAAAASLAAIAIAFLAGCSSTKPVSQDTSPKPATSPAAPVTTAAMADPAADLIGRGCAQYAAQ,-1,-0.45065317,0,1
P9WK61,MKRGLTVAVAGAAILVAGLSGCSSNKSTTGSGETTTAAGTTASPGAASGPKVVIDGKDQNVTGSVVCTTA,-1,-0.77920043,-1,0
P9WGU0,MKIRLHTLLAVLTAAPLLLAAAGCGSKPPSGSPETGAGAGTVATTPASSPVTLAETGSTLLYPLFNLWGP,-1,-0.5804437,-1,0
P0A609,MPKPADHRNHAAVSTSVLSALFLGAGAALLSACSSPQHASTVPGTTPSIWTGSPAPSGLSGHDEESPGAQ,-1,-0.6980984,-1,0
P00807,MKKLIFLIVIALVLSACNSNSSHAKELNDLEKKYNAHIGVYALDTKSGKEVKFNSDKRFAYASTSKAINS,-1,-0.67879725,-1,0
Q9ZIN7,MKIKHFLIALVAICLVLAGCSNSDSGDKKDSKKSDSNDKKQELQISAAASLTDVSKDLEKEFKKDHPDAK,-1,-0.7203028,-1,0
Q9Z692,MTVLGTKACKRLGLAAVTLASVAALMACGNKQSASTDKKSEINWYTPTEIITLDISKNTDTYSALAIGNS,-1,-0.62650454,-1,0
P31306,MKKGKILALAGVALLATGVLAACSNSTSNSSNSSSSGADQVFNYIYEVDPENLNYLISSKAATTDLTANL,-1,-0.73776597,-1,0
Q00749,MKWYKKIGLLGIVGLTSVLLAACNKSKASQSKEDKVTIEYFNQKKEMDATLKKIIKDFERENPKIHVKMT,-1,-0.79586375,-1,0
Q53919,MRRIAGLLVAPLLLLSAVACGSDDKASDSASSKNGVPAITAGAKFGEKPTLSKGEGDPPKELKTDVISEG,-1,-0.6272275,-1,0
Q9X9R7,MRTSIRRSQRLMALAAVAALTTGLLAGCASDSDDGSSDNSGGDGGGGKGKITLTIGTFGVFGYKQAGLYD,-1,-0.76732063,-1,0
O68456,MFKKVSKKFALLIVAMFTLGIILSGCATTQNNQSNSSSTTPSSNESTKAPEKIKIGFSMDNLALERWQKD,-1,-0.73747545,-1,0
Q8NNK2,MEQQNKRGLKRKALLGGVLGLGGLAMAGCEVAPPGGVLGDFLRMGWPDGITPEAVAMGNFWSWVWVAAWI,-1,-0.7044687,-1,0
Q9EZQ7,MTFSALPFRRADRRRLLAAALAACALTLTAACDSGTVTVPVTDSVTTSAVADPRFAELETTSGARLGVFA,-1,-0.7420043,-1,0
Q5YXD6,MPGVDISFLKKSGRRTMAAAAVIALLGGCGADAGSEPATTAASTTAPSAATDAATAEFAALEQRFGARLG,-1,-0.7742906,-1,0
P49941,MVRKCLLAVLMLLSVIVLPGCWDKRELTDLAIISAIGIDRTNDSNYVLHLQIINPGNVAGGLQGGGAGDR,-1,0.15698144,0,1
P9WK80,MIAPQPISRTLPRWQRIVALTMIGISTALIGGCTMDHNPDTSRRLTGEQKIQLIDSMRNKGSYEAARERL,-1,-0.6641933,-1,0
P9WK76,MPHSTADRRLRLTRQALLAAAVVPLLAGCALVMHKPHSAGSSNPWDDSAHPLTDDQAMAQVVEPAKQIVA,-1,-0.73360485,-1,0
P9WK70,MTDPRHTVRIAVGATALGVSALGATLPACSAHSGPGSPPSAPSAPAAATVMVEGHTHTISGVVECRTSPA,-1,-0.54830384,-1,0
A0LVS5,MRGTAVRTILRAACAAAVAVGVSGCMTVPTGGRVHAGSQASQDSQGGRNIQVPAAYAVEGLSPKDVVGGF,-1,0.028108347,0,1
Q6A830,MTLRPSRRAVLSAAAVLLTGCSEVPSQGPVKRADGPRAAAQESIDVAPHPPADGASIDLVVGGFLQAMAS,-1,-0.8313363,-1,0
Q82DB7,MGAEGGGRRRALRLGAYVGCGAVLLTGCASMPDSGDLRGVESTPRQDAQVRVFAMPPREDAAPAEIVQGF,-1,-0.7124937,-1,0
O33192,MTAHTHDGTRTWRTGRQATTLLALLAGVFGGAASCAAPIQADMMGNAFLTALTNAGIAYDQPATTVALGR,-1,-0.5169474,-1,0
P54544,MLKTYQKLLAMGIFLIVLCSGNAAFAATNQVGGLSNVGFFHDYLIEPFSALLKGVAGLFHGEYGLSIILV,-1,19.879955,20,21
A0R1E8,MTQNCVAPVAIIGMACRLPGAINSPQQLWEALLRGDDFVTEIPTGRWDAEEYYDPEPGVPGRSVSKWGAF,-1,4.1051745,4,5
Q9L1P4,MESPIRTARRTLPLLIGATCLVLALTGCAGEDGPAQARPTPSASTSPKQAPALSAAQARDVITRYSKINN,-1,-0.77482307,-1,0
P9WK45,MRTPRRHCRRIAVLAAVSIAATVVAGCSSGSKPSGGPLPDAKPLVEEATAQTKALKSAHMVLTVNGKIPG,-1,-0.8049686,-1,0
P40406,MRPVFPLILSAVLFLSCFFGARQTEASASKRAIDANQIVNRMSLDEKLGQMLMPDFRNWQKEGESSPQAL,-1,10.610774,11,12
P9WHR3,MGMRLSRRDKIARMLLIWAALAAVALVLVGCIRVVGGRARMAEPKLGQPVEWTPCRSSNPQVKIPGGALC,-1,16.796278,17,18
P9WK65,MNDGKRAVTSAVLVVLGACLALWLSGCSSPKPDAEEQGVPVSPTASDPALLAEIRQSLDATKGLTSVHVA,-1,-0.7749381,-1,0
Q8G848,MKNWKKAIALVASAAALVSVAACGSSNAGGSSDSGKKTVGFVAVGPEGGFRTANEKDIQKAFEDAGFDLT,-1,-0.76602614,-1,0
O07013,MKSKVKMFFAAAIVWSACSSTGYAAAIEKEKHVSELRAEDLFVKKVEGMNKDFIKGADVSSVIALENSGV,-1,-0.7679417,-1,0
Q93LK7,MKRWILFLILSVFLIGCAKTKIVDDIDLVQVAAYDTEAEGKLKGTFAISAYKGGGEGETKIYSASGQTGR,-1,-0.64320254,-1,0
Q93N68,MEMKHLLKIIMVMALTGFMSGCSELEEIEERGFVVGAAYDIVKEKKANPIMKGTYQMVLPSKLSQQGGQG,-1,-0.69162387,-1,0
P16450,MSKAKTLLMSCFLLLSVTACAPKDQAADMDYDQTKKMVVDILKTDDGKKAIKELLNDDAMNEALVIDQDA,-1,-0.63351446,-1,0
O34563,MKKIFSLALISLFAVILLAACGSKGSNGEASKESKKDTLAAIKDNDKIVFGVKTDTRLFGLKNPSSGEIE,-1,-0.6205229,-1,0
P48242,MSAKRTFTRIGAILGATALAGVTLTACGDSSGGDGFLAAIENGSVNVGTKYDQPGLGLRNPDNSMSGLDV,-1,-0.73811567,-1,0
P27676,MKRKTVWKIWITLALIALLSITALAGCSSESSTTNKEDGAKSTETSAGTNTLEKIKKRGKLIVGVKYDLN,-1,-0.7444881,-1,0
Q5HGV1,MRIIKYLTILVISVVILTSCQSSSSQESTKSGEFRIVPTTVALTMTLDKLDLPIVGKPTSYKTLPNRYKD,-1,-0.76720434,-1,0
I6Y9J2,MPKVGIAAQAGRTRVRRAWLTALMMTAVMIGAVACGSGRGPAPIKVIADKGTPFADLLVPKLTASVTDGA,-1,-0.59828967,-1,0
P9WK73,MRLPGRHVLYALSAVTMLAACSSNGARGGIASTNMNPTNPPATAETATVSPTPAPQSARTETWINLQVGD,-1,-0.687796,-1,0
Q6NIS1,MRNHVSRYLTALIAVGCAATTAACTSLPSNSEPQALRSFEASASEEPQGPVEDQEPDLLLRDFYEANNNP,-1,-0.80209225,-1,0
Q4JTP9,MSNKTTEATKTTKVKKVLSVVAGLGLLAGCSTLPDDTNPEAISSYAPAPSGQEAPTPTDGQPSDLLLRDF,-1,-0.75522137,-1,0
P65309,MNRCNIRLRLAGMTTWVASIALLAAALSGCGAGQISQTANQKPAVNGNRLTINNVLLRDIRIQAVQTSDF,-1,-0.7574785,-1,0
P96264,MVNKSRMMPAVLAVAVVVAFLTTGCIRWSTQSRPVVNGPAAAEFAVALRNRVSTDAMMAHLSKLQDIANA,-1,13.678277,14,15
P9WGU9,MVMSRGRIPRLGAAVLVALTTAAAACGADSQGLVVSFYTPATDGATFTAIAQRCNQQFGGRFTIAQVSLP,-1,-0.7459792,-1,0
Q9CC94,MRDVWSLPCRKSLLGVAAVVLVSGTLTGCSSGDSTVAKTPVPPSTTTGTISTIISSAPSPPFATAAPPTS,-1,-0.6445801,-1,0
P65317,MACLGRPGCRGWAGASLVLVVVLALAACTESVAGRAMRATDRSSGLPTSAKPARARDLLLQDGDRAPFGQ,-1,-0.7866299,-1,0
P9WK41,MRWIGVLVTALVLSACAANPPANTTSPTAGQSLDCTKPATIVQQLVCHDRQLTSLDHRLSTAYQQALAHR,-1,-0.6054387,-1,0
P9WK39,MKRTSRSLTAALLGIAALLAGCIKPNTFDPYANPGRGELDRRQKIVNGRPDLETVQQQLANLDATIRAMI,-1,-0.8111435,-1,0
P37966,MKIRMRKKWMALPLAAMMIAGCSHSETSNSASGSKDTIKIMAPLLSPESPSDKSPSLKALEKYTGKEIKV,-1,-0.79808545,-1,0
P9WK69,MRRQRSAVPILALLALLALLALIVGLGASGCAWKPPTTRPSPPNTCKDSDGPTADTVRQAIAAVPIVVPG,-1,15.112691,15,16
A0JYG9,MTGTPSKLRNAALALMTLLLLLLTSCAQIPRSGPVGKSTDESAGKPNNAPVFFPVAPREGAGPESVIEDF,-1,-0.71867394,-1,0
B1MHR6,MMNRVIVGAMGLLAAGAVVVGCSNDKPAGAAQVSSGSNAEVKVDGKDLAGLDLKSVTCVKQGGNINVASA,-1,-0.6688157,-1,0
T2GP47,MRWPMQNRTTAVIAVALATTALVACSSRSASAVSSTATVTVDGKDSTMHIVKCTQLEWYRMINIGSDFAG,-1,-0.34544674,0,1
Q8G849,MRRVTRTIAAAGAAIACCVTMTACSSPFDLPISGSVQTLAPVEQQTQRVYTNPQGPADDAQPETIVKGFY,-1,-0.6848941,-1,0
P31502,MKRQLTVAVAGAAILAAGISGCSGGNKSGTSASSSANSSGTTRRLAPGAAGTKVTIDGKDQNVSGSVVCT,-1,-0.7840892,-1,0
P59213,MSSKFMKSAAVLGTATLASLLLVACGSKTADKPADSGSSEVKELTVYVDEGYKSYIEEVAKAYEKEAGVK,-1,-0.75007725,-1,0
O32436,MITRLVMIFSVLLLLSGCGQTPFKGKIEKVGMLFPDTINDLVWGTKGYKGLLNIQSKYNVDVYYKEGVKT,-1,-0.7168747,-1,0
Q02112,MKKFIALLFFILLLSGCGVNSQKSQGEDVSPDSNIETKEGTYVGLADTHTIEVTVDNEPVSLDITEESTS,-1,-0.68539417,-1,0
O06989,MVLLKKGFAILAASFLAIGLAACSSSKNPASSDGKKVLTVSVEETYKEYIESIKTKFEKENDVTVKIVEK,-1,-0.7545638,-1,0
Q01625,MLLKRRIGLLLSMVGVFMLLAGCSSVKEPITADSPHFWDKYVVYPLSELITYVAKLTGDNYGLSIILVTI,-1,-0.7847131,-1,0
P0A5Y1,MRWIGLSTGLVSAMLVAGLVACGSNSPASSPAGPTQGARSIVVFAAASLQSAFTQIGEQFKAGNPGVNVN,-1,-0.66932905,-1,0
A0QQ71,MKIRAHHKIATAAACVALLASACSGSDKPQSTTAEGFPETITLAAIPAENSSDLKASYDPLIKMLEKQTG,-1,-0.7299874,-1,0
Q88T16,MKYRLIGVGASLVVAVMLTGCQAKATTLVKSDAGQVTQAEVFKQIENQATTQQAVQELTLNKVLNQRYHV,-1,-0.78870183,-1,0
Q0TMG9,MVSVKKIVASALVGVLMFSAVGCNMVEKTQAAIDKTTVATVNGEKITLGEVDSHLKGVFAQMKSQYGDKY,-1,-0.65794575,-1,0
Q9CEV9,MKFKKLGLVMTTVFAGAALVTLSGCSSSDSASKDIITMKGDTIRVSDLYKEAKQFPSQPTNTLLQNLTFD,-1,-0.7953567,-1,0
Q8DZV4,MKMKKNIFLLTLLATVLLTLSGCANWIDKGQSITSVGSTALQPLVEAAADEFGKTNLGKTINVQGGGSGT,-1,-0.73480904,-1,0
P9WGT8,MKFARSGAAVSLLAAGTLVLTACGGGTNSSSSGAGGTSGSVHCGGKKELHSSGSTAQENAMEQFVYAYVR,-1,-0.7430494,-1,0
Q81TU1,MRGKHIFIITALISILMLAACGQKNSSATVATATDSTITKSDFEKQLKDRYGKDMLYEMIAQDVITKKYK,-1,-0.72555447,-1,0
P60812,MKQMNKLITGVVTLATVVTLSACQSSHNNTKLVSMKGDTITVSDFYNETKNTELAQKAMLSLVISRVFET,-1,-0.7426026,-1,0
Q9KDN4,MKKRHLLIAGLACMTILGACNNDDAGSSGQAVVEVDGHEISDAEFVDMLKERYGEAILQELVQRHLISQA,-1,-0.8353889,-1,0
Q8CNR4,MKLMNKIIVPVTASALLLGACGSNATESKDNTLISSKAGDVKVADVMKKMGKEQIANTSFSIVLNKVLAD,-1,-0.73599696,-1,0
Q8CP98,MKKWQLVGTTVLGASVLLGACGGNDGGSGDGKDLKGSAKGEGSSTVAPIVEKLNEKWAKDHKDAKISSGQ,-1,-0.79688823,-1,0
Q4L565,MSKFKSLLLMFGTLILLSGCSNVEVFNAKGPVASSQKFLIIYSIIFMLVIVAVVLTMFAIFIFKYSYNKN,-1,-0.7586636,-1,0
P9WG28,MLRLVVGALLLVLAFAGGYAVAACKTVTLTVDGTAMRVTTMKSRVIDIVEENGFSVDDRDDLYPAAGVQV,-1,16.814161,17,18
P39910,MRYRAVFPMLIIVFALSGCTLSTINPMKKSRIDNIHHTQILFFSDENQIDQEAPYYDALLDLEKDYPEQI,-1,-0.8290718,-1,0
O34406,MNKRKGLVLLLSVFALLGGGCSQTNNKTDRQAQTVIVGTGTDFPNIAFLNEKGELTGYDIEVMKAIDKEL,-1,-0.6589925,-1,0
P42461,MSISRTVFGIAATAALSAALVACSPPHQQDSPVQRTNEILTTSQNPTSASSTSTSSATTTSSAPVEEDVE,-1,-0.6960074,-1,0
A0QYB5,MRLGTTAFAIASATALGLGLTACGAGDPAANSDTTRIGVTVYDMSSFITAGKEGMDAYAKDNNIELIWNS,-1,-0.26078185,0,1
Q9K9G5,MKSFKIISLLLAILFLASCQTNTASDDEALETVEVMLDWYPNAVHTFLYVAIENGYFAEEGLDVDIVFPT,-1,-0.68357897,-1,0
Q93KD6,MKRLLSIITAVMMLALALTGCAAKQSPEGEVEKTQAKGSIILATTTSTSDSGLLDYLLPEFTKDTGIEAK,-1,-0.7513956,-1,0
Q2YUT0,MIKRVNKLVIGISLLFLVISITAGCGMGKEEEIKKSFEKTLSMYPIKNLEDLYDKKGYRDDQFDKNDKGT,-1,-0.75989455,-1,0
P9WLE1,MGAPLRHCLLVAAALSLGCGVAAADPGYVANVIPCEQRTLVLSAFPAEADAVLAHTALDANPVVVADRRR,-1,7.600647,8,9
Q92F67,MKLLKKGTTVLFVMIMAVMLVACGDKEESKTFSLSQNGVDSKLTYTYKGDKVTKQTAENTMLYTSMGIKT,-1,-0.7360982,-1,0
Q6GE63,MKKLVTGLLALSLFLAACGQDSDQQKDSNKEKDDKAKTEQQDKKTNDSSKDKKDNKDDSKDVNKDNKDNS,-1,-0.7170923,-1,0
Q6ACU3,MTKTTRLLRATTVAAILLGLTGCAVHLPASAQTPGKQADGVQVSKAWVKAAGSGMTAAFGDVKNTGSGTA,-1,-0.7747953,-1,0
P9WL77,MAPRRRRHTRIAGLRVVGTATLVAATTLTACSGSAAAQIDYVVDGALVTYNTNTVIGAASAGAQAFARTL,-1,-0.81153417,-1,0
Q9RKQ0,MSQDRGPRRPRRLEKCALISASATVLSLTASGCVVVHGEREVLPSATRAEAAKALERFTTAYNKADKAYD,-1,-0.764305,-1,0
P29761,MSRKLIKYLPLLVLASSVLSGCSNNVSSIKIDRFNNISAVNGPGEEDTWASAQKQGVGTANNYVSKVWFT,-1,-0.78820693,-1,0
P42061,MKRRKTALMMLSVLMVLAIFLSACSGSKSSNSSAKKSAGKPQQGGDLVVGSIGEPTLFNSLYSTDDASTD,-1,-0.7895684,-1,0
P94528,MKKMTVCFLVLMMLLTLVIAGCSAEKSSGKSGETELTFWTFNGLHEQFYVEMVKEWNKKYPDRKIKLNTV,-1,-0.56980705,-1,0
Q9KEE7,MGKNILFFSFVGVMVLVLVACGGSSSSSSDADETSVIGDDIEGATELIFWTFAGQHVDLFEDAVVSWNEE,-1,-0.559518,-1,0
A3DHD2,MSIKKLILAASILTTLALTGCGGKGAVQPSGVSTGDVNAKIVFDNDKVNADNVDGLSVSEREVKITKPGM,-1,-0.79307604,-1,0
Q04441,MKLWKTASRFLPLSFLTLFLTGCLGEENLTALDPKGPQAQWIYDNMILSIIVMALVSIVVFAIFFIILAK,-1,-0.7173178,-1,0
P94446,MGKKMTIASLILMTAGLTACGANDNAMNDTRNNGNTRPIGYYTNENDADRQGDGIDHDGPVSELMEDQND,-1,-0.7589026,-1,0
O07009,MKMAKKCSVFMLCAAVSLSLAACGPKESSSAKSSSKGSELVVWEDKEKSNGIKDAVAAFEKEHDVKVKVV,-1,-0.7160232,-1,0
P26906,MKRVKKLWGMGLALGLSFALMGCTANEQAGKEGSHDKAKTSGEKVLYVNNENEPTSFDPPIGFNNVSWQP,-1,-0.79267955,-1,0
Q99WN4,MKKLTTLLLASTLLIAACGNDDSKKDDSKTSKKDDGVKAELKQATKAYDKYTDEQLNEFLKGTEKFVKAI,-1,-0.75235844,-1,0
Q49803,MSRWTHRTFFIALSAIVTTAGFGSSGCAHGNSSTSESAVPSTFPGISSSITAPPATGLPAPEVLTNVLSR,-1,-0.7561872,-1,0
Q8NMT9,MRVFRGRRGAVAGSFLAVLAIGSLALTGCTIERSDAQEQSSQQSTEVEAEEAQAPVISVDDGDEDVDPSE,-1,-0.80493253,-1,0
Q9CD47,MQAIRLGLHTAAAVVTLSISAVSCGTKTPDYQLILSKSSTTTTTTPDKPIPLPQYLESIGVTGQQVAPSS,-1,-0.46046045,0,1
P9WK50,MSTTRRRRPALIALVIIATCGCLALGWWQWTRFQSTSGTFQNLGYALQWPLFAWFCVYAYRNFVRYEETP,-1,0.32027823,0,1
Q6AGI5,MTRRSGPAVARYRVVAAALVASLVVLLAACASIPDSGPVRQGGPIAQVSDQLDLDFNPSPPEKGASPQRI,-1,-0.76572907,-1,0
Q47LZ5,MIGQANRIAAAVSTACLAVLLAGCATVPTGGPTFEGRGGGAQGQVDTFTRLLPAGPQPGWGENALVRGFL,-1,-0.45331857,0,1
P9WK56,MRPSRYAPLLCAMVLALAWLSAVAGCSRGGSSKAGRSSSVAGTLPAGVVGVSPAGVTTRVDAPAESTEEE,-1,-0.6528759,-1,0
P9WK53,MRRKVRRLTLAVSALVALFPAVAGCSDSGDNKPGATIPSTPANAEGRHGPFFPQCGGVSDQTVTELTRVT,-1,-0.80937105,-1,0
P67225,MTSTLHRTPLATAGLALVVALGGCGGGGGDSRETPPYVPKATTVDATTPAPAAEPLTIASPMFADGAPIP,-1,-0.7105373,-1,0
O07750,MCNRLVTVTGVAMVVAAGLSACGQAQTVPRKAARLTIDGVTHTTRPATCSQEHSYRTIDIRNHDSTVQAV,-1,-0.50568664,-1,0
P9WK67,MRARPLTLLTALAAVTLVVVAGCEARVEAEAYSAADRISSRPQARPQPQPVELLLRAITPPRAPAASPNV,-1,-0.61046934,-1,0
P9WK54,MKHPPCSVVAAATAILAVVLAIGGCSTEGDAGKASDTAATASNGDAAMLLKQATDAMRKVTGMHVRLAVT,-1,-0.53778744,-1,0
P15698,MKKFIKILKVLSMAIVLSACNINGIFASNLNTTNEPQKTTVFNKNDNTWNAQYFRIPSLQTLADGTMLAF,-1,-0.73922825,-1,0
P42708,MRRYLILIVALIGITGLSGCYQTSHKKVRFDEGSYTNFIYDNKSYFVTDKEIPQENVNNSKVKFYKLLIV,-1,-0.7072389,-1,0
O32243,MTKIKWLGAFALVFVMLLGGCSLPGLGGASDDTIKIGAQSMTESEIVANMIAQLIEHDTDLNTALVKNLG,-1,-0.69592595,-1,0
Q9CEK0,MKKLKVTLLASSVVLAAALLSACGSNQNSSTSTKKLKAGNFDVAYQNPDKAIKGGNLKIAYQSDSPMKAE,-1,-0.7498379,-1,0
Q8CVC9,MKKHKMLSLLAVSGLMGIGILAGCSNDSSSSSKGTINIVSREEGSGTRGAFIELFGIESKNKKGEKVDHT,-1,-0.7199323,-1,0
Q8R760,MRRKIALFLALIFVGVSLVSCSSKKEAVSGDVVAVVNGEKITNAEYQQIFEQVKEQIESAPTYTKDIWNQ,-1,-0.22423817,0,1
P40400,MKKGLIVLVAVIFLLAGCGANGASGDHKQLKEIRIGIQQSLSPLLIAKEKGWFEDAFEKEGIKVKWVEFQ,-1,-0.72854924,-1,0
P42199,MKKALLALFMVVSIAALAACGAGNDNQSKDNAKDGDLWASIKKKGVLTVGTEGTYEPFTYHDKDTDKLTG,-1,-0.65017295,-1,0
Q48754,MKKRTFALALSMIIASGVILGACGSSSDDKKSSDDKSSKDFTVAMVTDTGGVDDRSFNQSAWEGLQKFGK,-1,-0.74121606,-1,0
P06109,MTARRTRWTRRTDRSLPIRSAAAAVAFAAGATACSAPTGGGGDGGTEAAESVVIGVASEPDTLSPLLGYG,-1,-0.780361,-1,0
Q8CN89,MKKVLASATILSLMLVGCSNGGNDESSHKDDSSKTEQKDKSSSQHDSKKDSKRNDTNNKQDNQENKSNKE,-1,-0.76954806,-1,0
Q53936,MKLKYTAAWVGLTAAAMVAATACGSDGAKTAAGTADKAVDKGTAVMAALTRATDRTEELGSAEVRTTTEL,-1,-0.709279,-1,0
P16085,MNKKAIVGIFMSILMAGLVGCAGSSDAQAGDDLKPVIYLYPQEDNTEISVSLDYNGNLVDLIPEFNADKT,-1,-0.7282924,-1,0
P41108,MTGTTARRTVVSVAVSAALACVTACTGPGGSDDAGHSTGPTGSARPSASAPASSRAPALTGPSADALRKV,-1,-0.7973883,-1,0
Q49ZU4,MKKLLAGFLTLSLALAACSNGSDDDSSKKDDSSKDNQSSDDKSKDSKNDDKKNNDSDKDKDNNSDSDKNS,-1,-0.7558367,-1,0
P41109,MKTSVRVPVGAGLAALLLAAGAVGCAKEDKASESPEMTPAAAVAKAAKNTEEINSLHYRMTGKVPEEGRV,-1,-0.507627,-1,0
Q6AFL2,MTEIRYVRLLTLVLASSVLLAGCSSAVPTTPVRSATPSAAATPTATPVVPPTVNPAATASLHAAARSGDA,-1,-0.8024839,-1,0
O34538,MFQKKTYAVFLILLLMMFTAACSGSKTSAEKKESETEKSSDIAQVKIKDVSYTLPSKYDKSTSDDQLVLK,-1,-0.69264424,-1,0
O34968,MKKWMTVCALCFVFFLLVSCQQKDAVPDTAKKLKAPLTGLKTEQKVTERRPVAVVVNNHPKARPQSGLSK,-1,-0.48572162,0,1
Q8CMK8,MKKKALLPLFLGIMIFLAGCDYSTPEKQDGFFFNTFVQPMKHLLQWLGNDVFHNNFGLAIIVLVLFIRLI,-1,-0.7491895,-1,0
Q9CHZ9,MKNLKKKLTLTGLMTAGLLFLSGCVQTHVVDGVRVPTEAATHGITYNFLVRPMSAFVDLFANNLHMGYGW,-1,-0.78198636,-1,0
Q8E3U9,MKKTLKRILFSSLSLSILLLLTGCVSVDKAGKPYGVIWNTLGVPMANLITYFAQHQGLGFGVAIIIVTII,-1,-0.7521061,-1,0
P96667,MKKRRKICYCNTALLLMILLAGCTDSKDGEAQQPSNQASAVQTDEKHTEPEESTKIRKDEAEPITESEES,-1,-0.8278303,-1,0
O34629,MKKTLALAATAAVLMLSACSSGFGGEKEEEITQKTAKSSEKAIVPKYNISDSYYKMVLPFKAGKARGLTT,-1,-0.74930525,-1,0
O34866,MKKSGKWFSLAAALSVTAIVGAGCSMSNGDAQKDTKTTAETKQTEQKTADSKKSNTQNSEFSLESQYFND,-1,-0.71769637,-1,0
Q9RN00,MCKRFKFLLAVSALFISITVVLAGCGGSSVPYKKDDTYKDSKDNFITITAENEWRVKGSQNSEANYKVES,-1,-0.78975105,-1,0
P97029,MSMKTKAAFHLVLFGLACWALISYFEASEGIASFFGTKSGGMVFDLNLTPFILFVAASAVYLYLQKKSRP,-1,20.932472,21,22
C0SP99,MKLSLFIIAVLMPVILLSACSDHAEEHASINTKKTVENITDVRKTAKTSIDWTKPSGGEYPDIKQKHVWI,-1,-0.5533785,-1,0
C0SP94,MKKTLIILTVLLLSVLTAACSSSSGNQNSKEHKVAVTHDLGKTNVPEHPKRVVVLELGFIDTLLDLGITP,-1,-0.6312178,-1,0
Q71ZU1,MKKKNIILISVLLGALLLLTGCSMDPSQNTDGFFSTYLIQPFTSFIMFVAKFVGGNYGIAIIITTLLIRA,-1,-0.7739643,-1,0
P94492,MKKILISMIAIVLSITLAACGSNHAAKNHSDSNGTEQVSQDTHSNEYNQTEQKAGTPHSKNQKKLVNVTL,-1,-0.7103778,-1,0
O31486,MRHVLIAVILFFLSIGLSAGCAEAGNKTQNQSATEVNASPLQPAEYFIYHNLMNDKGLIKTDFSDQPSYL,-1,3.5506134,4,5
Q8CX16,MKKKLKTFSLILLTGSLLVACGRGEVSSHSATLWEQIVYAFAKSIQWLSFNHSIGLGIILFTLIIRAIMM,-1,-0.7383561,-1,0
Q97NI6,MKKKLKLTSLLGLSLLIMTACATNGVTSDITAESADFWSKLVYFFAEIIRFLSFDISIGVGIILFTVLIR,-1,-0.7438686,-1,0
O31555,MKNQEIIEVKSKMFLRIWAFVGSAGMGLACLWLFYMGITFQTKYYLLAIPAGFLFTLFCLYLFIIFFPAF,-1,11.876402,12,13
Q04729,MNYFRILYCSVLLFFSFFSCTSAAVSNHPIHWGFQKNNNHQPPDAGKEWNELLNKYGAFYLGDPSKKEIY,-1,-0.57023853,-1,0
P54498,MLMRSVCFILLAVLLFSLSACEPSHQQQKQASAAKDEKKDIIPLSAEKADGAEGWLNNSTILYTASNPTK,-1,-0.3749179,0,1
P40770,MKQTVLLLFTALFLSGCSVASADDSVPRFTEEGKYIGSADPHTIAVSLNGEETMIQVPKDKRDECESLPD,-1,-0.42238113,0,1
P42307,MRRIGLCISLLVTVLVMSACESEGEAQMFADCDQKTVKQTAAKPMSSKKKQDFQALASDRQLAIVFSSMI,-1,0.18189389,0,1
O06965,MKKIIFICFSLLLALTGGCSMNDNDKNSTNDNKTEAVKPKDMDPKDLPQVPAFQDEKTREYMVSTKEEEP,-1,-0.46600154,0,1
O07634,MRILFIIIQLTLILSACAYQQGKQGQNVEKESTRQQETKPIHVKDTTQETKDNGTRTDIAKHLVSVAEKN,-1,-0.56379694,-1,0
O32208,MFKKYSIFIAALTAFLLVAGCSSNQSSTDSEKKVTLTISAAASAQDALEEIQKNYEKDHQHITIQDNYGS,-1,-0.74927723,-1,0
P54594,MKKWLICSFVLVLLVSFTACSPSAEHESIKIGIAESDGAIWNYIAQKAEEAGLDIQLIPFSDYAESDIAL,-1,-0.52864945,-1,0
P21884,MKDAIKRRPGIKIGAFCAMALILTGCMGQDPVDSLHHSLEKAAESEKPFQEEQNTLKELEAKENQLYDSV,-1,-0.8188932,-1,0
O05524,MRNPVVWGMIYFAVGCIFTYLAASSPGSMWSFYSILLMVFAAYNISISFKMFAFSFKIKKNQK,-1,14.076825,14,15
P54598,MFGKKQVLASVLLIPLLMTGCGVADQGEGRRDNNDVRNVNYRNPANDDMRNVNNRDNVDNNVNDNVNNNR,-1,-0.7319038,-1,0
O34725,MKKVLLLLFVLTIGLALSACSQSSDASEKEKPKEKKSQEELEKELDKELKKGGEPKTKKDDQIHKIGETF,-1,-0.43150327,0,1
O32005,MNIRFSMLVCVSFIFFTGGCAESSANSNDGSKNKNESKEESSEEGVKENDNKLADTPNMDDCIEVYGKEE,-1,-0.5948381,-1,0
P54451,MKHFIILFLLLFVTAGCEGRGYEDVVAFGDSNTRGSNWDYRDYPKAQQWVNILKTAERGNLDILNAGIGG,-1,0.5178365,1,2
Q795R2,MGNKWRVLLIVLVLALGGVLAGCKGTDQSSAEGKAGPDSKVKLSWMAILYHQQPPKDRAIKEIEKLTNTE,-1,-0.44123253,0,1
C0SP80,MTKRIRTALCVIVSVLFLASCSSRPDGMHVILFSDMQAGVQEKIKKAAEQNAGKVDIFPAFQEKLLTEIT,-1,-0.7501042,-1,0
P94361,MKRLFLSIFLLGSCLALAACADQEANAEQPMPKAEQKKPEKKAVQVQKKEDDTSAWIKTEKPAKLPILMY,-1,-0.6165222,-1,0
P37488,MKIILTVLAGVGLLSAGGCGMLDQVNDGLNYTSEAAGYVEKVKTFAEEAPELAEKAVNDTEAKEKLEAQL,-1,-0.567629,-1,0
Q53684,MRTRITLALAVLLLLLAGCSPGAPADGPVTLRFQSLAWQPDSVAATKELVGEWNATHPDVKVEYIQGSWD,-1,-0.49189964,0,1
C0H3R7,MKKIMLFLAMTSILSACQPNYTGKYIEIGDTLTDYTKECFKENEIPYKYEKGKLYIPEDAFDTAIYTCS,-1,-0.64716923,-1,0
O34805,MKKRAGIWAALLLAAVMLAGCGNPADQKDSKAKQKTEVFPVTIDDASNQDVTIKKEPKKIVSLMPSNTEI,-1,-0.7467982,-1,0
O31942,MKLFKKLGILLLITSLILLAACKNSEESSSSSEDTNNATDTNTSESQDISVNGPEKVGDVYEIDGGTAKV,-1,-0.75404096,-1,0
C0SP84,MNRWLRLGFACVGSIFLMFALAACKQEETLTKVKVAEVTHSIFYAPLYVAESKGFFKEEGLDVDVNTTWG,-1,-0.6748972,-1,0
O32128,MKRTAVSLCLLTGLLSGCGGAGLDNAQNVRNQTQNQTKPIHVSDRNEAFNRHNENEQFGYVRYQKEQFDG,-1,-0.6454431,-1,0
O35005,MRFKDQVHFIRRNMKKNRLRVFMTILATTMACAFLVVLSSVGFGIQKTITDMTMSQQIVTKVSVMGKEGD,-1,-0.14875779,0,1
P54945,MVIPLRNKYGILFLIAVCIMVSGCQQQKEETPFYYGTWDEGRAPGPTDGVKSATVTFTEDEVVETEVMEG,-1,-0.7225481,-1,0
O31851,MHRLLLLMMLTALGVAGCGQKKPPDPPNRVPEKKVVETSAFGHHVQLVNREGKAVGFIEIKESDDEGLDI,-1,0.37413085,0,1
P39613,MRISSCLYGFVAHGAVFLFTGGCMLLAMAASLPFVFLLDRLPDVVFTAGAILTLLCSYAYVWFWAVRFAY,-1,13.811592,14,15
P54952,MKMKKWTVLVVAALLAVLSACGNGNSSSKEDDNVLHVGATGQSYPFAYKENGKLTGFDVEVMEAVAKKID,-1,-0.7679126,-1,0
Q8KRU5,MTSRYRSSEAHQGLASFSPRRRTVVKAAAATAVLAGPLAAALPARATTGTPAFLHGVASGDPLPDGVLLW,-1,-0.7495189,-1,0
Q0PCD7,MFVLNEFTRRGFLGTAAAVGGTTVVTTALGGAPAAQAAVPEAADGGACGARTALVKVDRVDRRYQDLVTR,-1,-0.5914295,-1,0
Q3L8N0,MDGFSRRRMLMTGGALGAVGALGAATRALARPLWTWSPSASVAGTGVGVDPEYVWDEEADPVLAAVIDRG,-1,-0.80478656,-1,0
Q50EA3,MNDDARPAPEPQDIPPHSGAADEVNRQDPSRRSVLWTTAGVAGAGLGLGALGAGTASAAGRSAPDAVAAA,-1,-0.7545834,-1,0
A4FN60,MAGDESRSNPFSRRTLLRTSAAAGAGLGVAGLSTGYGAAQPVRPAKGESMMGVAFEAHETVRVGIIGVGN,-1,-0.6974294,-1,0
Q50HM6,MNDAAPQNPGQDEAKGTGEKDNGGSMSPRSALRTTAGVAGAGLGLSALGTGTASASVPEAAQTAVPAAES,-1,-0.49614277,0,1
B1VTI4,MPMNRREMVMATTGAALAAAAAVPLLSGGEGEGAAEAAAAPAKATGRGREHTERYLGRSIRVAAPADGGG,-1,-0.65202767,-1,0
P26222,MSPRPLRALLGAAAAALVSAAALAFPSQAAANDSPFYVNPNMSSAEWVRNNPNDPRTPVIRDRIASVPQG,-1,-0.24351801,0,1
E8MGH9,MHHSTRKRWLASIGAVAAVATLATGGAVTAQAADAPVIKNADVAYPSFKGSDDPMKTAANNTTYNPAVSY,-1,-0.7019902,-1,0
P82594,MCTREAVRMSREHDLPEIPSRRLLLKGAAAAGALTAVPGVAHAAPRPAPYENPLVRQRADPHIHRHTDGR,-1,-0.46905318,0,1
P0CZ00,MFGTPSRRTFLTASALSAMALAASPTVTDAIAAPGPDSWSALCERWIDIITGRRAARTSDPRARAIIAKT,-1,-0.74687755,-1,0
Q44052,MMNLSRRTLLTTGSAATLAYALGMAGSAQAATAVTARPGVPVTAAPPLRLASRNSVFTRSGAGPRYWNIY,-1,-0.75886834,-1,0
P30343,MTSPSPTARRTRLRRRTALALAAAATAALTLSACGTDTKANTPATRAGSGNAAAAKADTVALLDDTTLAV,-1,-0.75244,-1,0
I6WZK7,MPELATSGNAFDKRRFSRRGFLGAGIASGFALAACASKPTASGAAGMTAAIDAAEAARPHSGRTVTATLT,-1,-0.4274764,0,1
Q9RRF6,MTDPDSTSPAPDPQQPADPQPTDPGRREVLRQGALLTATALGLGGGLTLLTRRPAPAEPAPDPQTAAGRV,-1,1.9049098,2,3
P9WIB0,MVSQGAFAGMSRRAFLAKAAGAGAAAVLTDWAAPVIEKAYGAGPCSGHLTDIEHIVLCLQENRSFDHYFG,-1,-0.22766836,0,1
P52320,MERTTLRRRALVAGTATVAVGALALAGLTGVASADPAATAAPPVSADSLSPGMLAALERDLGLDEDAARS,-1,-0.716964,-1,0
Q5SK82,MKRVSRRAFLRRLGVGVAATAAFSPLAVAQARRYRWRIQTAWDAGTVGYSLFQKFTERVKELTDGQLEVQ,-1,-0.7941524,-1,0
P55046,MPDITRRRAYTTAAAVAATASAAAPTAAPAATAAARHDHTAPDSFDEVYKGRRIQGGPASGGGHHHEHGG,-1,-0.7717591,-1,0
P55047,MPELSRRRALGAAAALAAAAGTQAVAAPAATAAGHHPGPSTAATGHHPGTPASFDEVYKGRRIQGRPAAG,-1,-0.7932361,-1,0
P55048,MPRLTRRRALTAAAALASGAGAGAGAQAAAAPGAAAHDHGSPDVPLPCSLLDLLPLLPLLLDEVIKGRGI,-1,-0.7554927,-1,0
P26220,MQQDGTQQDRIKQSPAPLNGMSRRGFLGGAGTLALATASGLLLPGTAHAATTITTNQTGTDGMYYSFWTD,-1,0.06887777,0,1
Q9RRY7,MSVVSPDPAPVPHDPQRRALLRWLVGGGALAGGLGVSAVAQGYRFGVTHEQWNLVGLTRPVRLALLTDLH,-1,-0.57741225,-1,0
P9WL80,MGADLKQPQDADSPPKGVSRRRFLTTGAAAVVGTGVGAGGTALLSSHPRGPAVWYQRGRSGAPPVGGLHL,-1,-0.6349828,-1,0
P07883,MVNRRDLIKWSAVALGAGAGLAGPAPAAHAADLEWEQYPVPAAPGGNRSWQLLPSHSDDFNYTGKPQTFR,-1,-0.7237494,-1,0
P35393,MGTTGARPSRRAVLTAAAGAAVAGIPLGGSTAFAAPRGNPDVLRQLRALEQEHSARLGVYARDTATGRTV,-1,-0.6831695,-1,0
Q59517,MTGLSRRNVLIGSLVAAAAVGAGVGGAAPAFAAPIDDQLAELERRDNVLIGLYAANLQSGRRITHRLDEM,-1,-0.7768687,-1,0
P10509,MRLTQAPPSRRTLMTLGAGATMAALLPAGGAAYASTSTAKAPAAEGISGRLRALEKQYAARLGVFALDTG,-1,-0.23265402,0,1
P14559,MHPSTSRPSRRTLLTATAGAALAAATLVPGTAHASSGGRGHGSGSVSDAERRLAGLERASGARLGVYAYD,-1,-0.7154111,-1,0
P12676,MTAQQHLSRRRMLGMAAFGAAALAGGTTIAAPRAAAAAKSAADNGGYVPAVVIGTGYGAAVSALRLGEAG,-1,-0.642105,-1,0
P22637,MTDSRANRADATRGVASVSRRRFLAGAGLTAGAIALSSMSTSASAAPSRTLADGDRVPALVIGSGYGGAV,-1,-0.78592455,-1,0
P81594,MENNQKRQQSGMSRRSFLKVGAAATTMGVIGAIKAPAKVANAAETLNYVPGSGKIRSKLRPVHDFAGAKV,-1,-0.48892888,0,1
P63882,MNDLLTRRLLTMGAAAAMLAAVLLLTPITVPAGYPGAVAPATAACPDAEVVFARGRFEPPGIGTVGNAFV,-1,-0.48824885,0,1
Q47KB1,MTEPDTERKGSSRRGFLAGLGAAALTGAGIGMAAGEVLRPLLPDSDPAASPEAEQRLRMAAQRADATAAP,-1,-0.7535246,-1,0
Q59146,MPHDRKNSSRRAWAALCAAVLAVSGALVGVAAPASAVPATIPLTITNDSGRGPIYLYVLGERDGVAGWAD,-1,-0.63667685,-1,0
P39597,MSDEQKKPEQIHRRDILKWGAMAGAAVAIGASGLGGLAPLVQTAAKPSKKDEKEEEQIVPFYGKHQAGIT,-1,-0.7719399,-1,0
A0QXD9,MMSRESQPGLHRQLSRRNMLAAMGLAGAAAVSLPVLSACGVGGRTNAPNGASEVTGGFDWRKASGSTINI,-1,-0.38549328,0,1
Q67QZ1,MKFTRRSFVKASALATAMVAAGCSPQPVAPKQNPETEGATWYKTVCRYCGVGCGVMVAAKDNRVVAVKGD,-1,-0.8096429,-1,0
Q8GR90,MHKRRRLLAFATVGAVICTAGFTPSVSQAASSGDGEEKGSYAETHGLTADDVESINALNERALTLGQPGK,-1,-0.6742729,-1,0
P9WM45,MTTMITLRRRFAVAVAGVATAAATTVTLAPAPANAADVYGAIAYSGNGSWGRSWDYPTRAAAEATAVKSC,-1,-0.6417464,-1,0
Q60042,MRKKRRGFLNASTAVLVGILAGFLGVVLAATGALGFAVRESLLLKQFLFLSFEGNTDGASPFGKDVVVTA,-1,-0.35068727,0,1
O34870,MKKMSRRQFLKGMFGALAAGALTAGGGYGYARYLEPHMIETTEHTIKSSLIPHGFDGFKIVQFSDAHLSD,-1,-0.8021695,-1,0
P96809,MTGISRRTFGLAAGFGAIGAGGLGGGCSTRSGPTPTPEPASRGVGVVLSHEQFRTDRLVAHAQAAEQAGF,-1,-0.8007004,-1,0
Q8GJ31,MGEINRRNFLKVSILGAAAAAVASASAVKGMVSPLVADAADIVAPITETSEFPYKVDAKYQRYNSLKNFF,-1,-0.78041565,-1,0
P95028,MSVSRRDVLKFAAATPGVLGLGVVASSLRAAPASAGSLGTLLDYAAGVIPASQIRAAGAVGAIRYVSDRR,-1,-0.74569845,-1,0
Q9EX55,MTEVSRRKLMKGAAVSGGALALPALGAPPATAAPAAGPEDLPGPAAAAAGRRPAPAPVHVTRSDPRYQGL,-1,-0.6890656,-1,0
Q9RJC7,MTVTRRSVLIASTAAPAAGMALAAPSARAADATGGSAGRSTLALRDGWRFRLTDPDGAAEDDTDAADPAH,-1,-0.7152449,-1,0
Q9ZBW1,MPPRTRRPFWLALATSCALAVSSPFPAHARPGDRAPAFGEQVLFDAARDPGGYACFRIPAIVRTTDGTLL,-1,18.87923,19,20
Q9RD58,MHEPHLDRRLFLKGTAVTGAALALGATAAPTASAAPGGFPDYTYVRTLLTPSQLAYNPTGEIIFPTVRGV,-1,-0.73476815,-1,0
Q9Z510,MPGRPAPSRRTVLRSAAATPVAGLGLAACSPGDDGAAPARPTAPVDLGADGDVAKGATKLFPDGNVVVSR,-1,-0.79389775,-1,0
O07242,MLMPEMDRRRMMMMAGFGALAAALPAPTAWADPSRPAAPAGPTPAPAAPAAATGGLLFHDEFDGPAGSVP,-1,-0.7744477,-1,0
O05816,MLRAAPVINRLTNRPISRRGVLAGGAALAALGVVSACGESAPKAPAVEELRSPLDQARHDGALAAAAATA,-1,-0.6661978,-1,0
P71829,MMARMPELSRRAVLGLGAGTVLGATSAYAIDMLLQPRTSHAAPAAAIGTNVPLAPTPALDPAPPAQAAPT,-1,-0.783585,-1,0
A4QA36,MTSSFSRRQFLLGGLVLAGTGAVAACTSDPGPAASAPGPSLRPTPTPTALGEPTVRRTLTARPLSLDIGG,-1,-0.78483886,-1,0
A4QCC6,MRRPVSRRAIFATSVLVAGVSIMSPSANAAEAPASEWVNTTAIVDQANAQLSQFGVSLDRSAAELFDDQA,-1,-0.70791405,-1,0
A4QDY7,MAQISRRHFLAAATVAGAGATLAACAGTGGSTSSSSDSGSEGDTNTIVWWSNHPANSKDVELELISRFEA,-1,-0.8263742,-1,0
A4QFX3,MPQLSRRQFLQTTAVTAGLATFLGTPARAEERQFQHGVASGDPTATSAILWTRLTPIPDATPGSGLGPDS,-1,-0.76599276,-1,0
A4QI82,MTQPAPMCSRRMFLLGTATTFAGAFLAACGTEPDQEVAATEVPVGSSVILGSVIIAQPTEGNFVAYSSAC,-1,-0.67497504,-1,0
Q9EWT5,MGDIRRRGAVALGVTALVAPLTLALTAAPAQAASCTAKAGPYQKKVEKFLGRKADGKQSTADCKAIRAFQ,-1,-0.7521076,-1,0
Q9RJZ8,MERERTAPVPTRRRLLKGAALATVPYTLLSGTRAAAQVRAVDYPSAEWLPASTSNYSRSSRPTAYPVDFV,-1,-0.60096574,-1,0
Q9RJX4,MALTTRRRALTTLGAALTGAVALPAGTALASQGGHGPRPLWRAHAHNDYEHPRPLLDALDHRFGSVEADI,-1,-0.7940872,-1,0
Q9RKZ0,MQRRTRPTRTPGGLPLMSRVEQPSRRALLAAAVAAAAVTGGAIPATARAASRAGVGGGAAGPGRDSARRP,-1,-0.74209976,-1,0
Q8CJI8,MGTQESDERAGGGTGRRALLGAAVLGAGGAVLGLPGTARAAGTRHGGGHGGGVGSLPVPTVIGHRGASGY,-1,-0.6379895,-1,0
O88050,MGGVSRRAFTVAALSAFTLVPEASAATPGPAKPAPPRSAAAGMRGMWLATVANRDWPTRAGLRAAEQRAE,-1,-0.4554856,0,1
Q9X9W6,MSLTRRDFAGRSALTGAGVVLAGSVGALATAPNALASTDTDSVGAEHDGHDHHHGHGHGGVGYGPLLPDP,-1,-0.7738564,-1,0
Q9RDG9,MHHSSTAGTGSTAQPSRRSVLTATAVVTAALAAGGGTAYADARGPDDDTLRGLISRMTLEEKVGQLFVMR,-1,-0.6189771,-1,0
Q9L0J3,MTHTSRRGVLAAFAASAATVPFGGAAAASPARATATAASAVDPAAASAAPAGLTAARSSVTLPPLNPAYF,-1,-0.65732074,-1,0
Q9Z5A4,MDTTYWSRRRVLTVLGAATAATSIPLAAPSRALAAVGASSVGDLPKLPELPDTARAKAVTAWKVGGPTVK,-1,-0.7499785,-1,0
Q93S08,MSAISRRRFIRHGAVAGGAAVALPALGGWAGEAFAAQPSPAAAIAGGELVKVTPGDPRYATLVAGANGRW,-1,-0.76946455,-1,0
Q9ZBF6,MPHSPVSPAESPAPQPGRPRPVVSRRRLLEGGAAVLGALALSASPLTAQAAVRRAAADEPPEWNDFGVFR,-1,-0.23518457,0,1
O87849,MPSSPTPSPTPSGAPEPSGVRRRSLLAAAAAAPVLASLAGAGTAAADSPGGPRALPGGGDLGPNVIVFDP,-1,-0.43662968,0,1
Q9F3Q6,MSTEEQSSGRRHPDRRVLLRAAVAVPAAGAAVAGTAAVPAQAADAAGPSGGRFDADSPRFALAVLPDTQY,-1,-0.61245906,-1,0
Q9EWQ0,MSRQIDRRSFLRRGAAGAAALAVGPGLLAACSTDEPGSAGNPGPGSSPRSGGTLRAAFVGGGAAETLDFF,-1,-0.8159021,-1,0
B9W4V4,MHKSMRRFASGLLASVVTLSTAASIAPLSAFAGQQLGQNDFDAGVGLPWHTCETNPAKQKFDISGGTYNV,-1,23.647469,24,25
A9CH43,METLTRRAVLAIGAVGGTALAASTAGAASFGNPDQPAEGAINANAAGLSDPGPKNPAINDQFPSFQSPPA,-1,-0.7019871,-1,0
Q7M827,MSEQFTRREFLQSACITMGALAVSTSGVDRAFASSSLPINTSGIPSCDVLIIGSGAAGLRAAVAARKKDP,-1,-0.76768327,-1,0
A6VQE0,MNKFTKTDVTPEKLFIQRRKIIQGMSVLSAAAAFPNLAAAKKTEEKRTALSFKADNKPDLILTPENKVIG,-1,0.24172427,0,1
B4SRN1,MQRRDFIRNASLALAAFGLPSLPACAASKSGQMGLRRLGQPQPFDFATLKGQARALAQAPYKSHKRVLPG,-1,-0.79630905,-1,0
P07822,MSGLPLISRRRLLTAMALSPLLWQMNTAHAAAIDPNRIVALEWLPVELLLALGIVPYGVADTINYRLWVS,-1,12.16557,12,13
P0AAJ8,MNRRNFIKAASCGALLTGALPSVSHAAAENRPPIPGSLGMLYDSTLCVGCQACVTKCQDINFPERNPQGE,-1,-0.7593955,-1,0
P0AB24,MTINFRRNALQLSVAALFSSAFMANAADVPQVKVTVTDKQCEPMTITVNAGKTQFIIQNHSQKALEWEIL,-1,21.935162,22,23
P22641,MLGNFRFDDMVEKLSRRVAGRTSRRGAIGRLGTVLAGAALVPLLPVDRRGRVSRANAAGPAEGVDPRAKW,-1,-0.7540069,-1,0
P44652,MKVRLKSKKKMKKPALNPERRKFLKEATRTAGGLAGVGILLGLQQNQSLAREGVPLRPPFALQDAKAFSA,-1,-0.21471097,0,1
P71244,MPFKKLSRRTFLTASSALAFLHTPFARALPARQSVNINDYNPHDWIASFKQAFSEGQTVVVPAGLVCDNI,-1,-0.61929715,-1,0
Q59543,MKKDTGFDSKIEKLARTTASKTGRRGFIGRLGGFLVGSALLPLLPVDRRSRLGGEVQAATTGNLTRSGFK,-1,-0.73099345,-1,0
Q7MR39,MKPKPSDVTPKELFDQRRSFLKLGAASVVATGSVSNLLAALKTKAPSPLSFIPSENLENLKPNSFEQASG,-1,-0.76590556,-1,0
Q7NZY0,MLIRKPADHLPSEITSESVYFNRRQFMAGAAGLLLSAETLAGLAAKKSPLSQLAANDKPNSLKDITSYNN,-1,-0.54323655,-1,0
Q8DLH9,MEKVGRRVFLGMGAAATAYVTHHLWNQNAESSYAQQSSGGVINVYSARHYDTDKALYNTFTQQTGIRVNI,-1,10.293164,10,11
Q8PLY8,MSFRDALNLPSSEITDESVYRDRRRLLQLLALTPALGVAGCAEADPPPPPKTVVTPAQARSGFRTAEELT,-1,-0.70706064,-1,0
Q9HVA4,MLIKIPSRSDCSESEVTSETLYLSRRRLLGASFAGLALASGLPRLGFADEQRYAGVESVPAPGWFAEKLP,-1,-0.6375436,-1,0
A6LB54,MENTRRSFLKKVSAAGIGAAGLAMAGNAGATTTAAEPQKKKTAGKDDGKLRFGFIGTGSRCHEHINNVLA,-1,-0.7675533,-1,0
B2FLK4,MFAMKRREFIAASAAVAASSLLPQTPAWARGRKVRLAMIGTGMRGLVLLKELVRRDDVEVVALCDIEPIM,-1,-0.7016718,-1,0
B2UL75,MDNSSSRRRFLQTLGLATGALAAGSFANAQEVAPLAPKKITIPDPNNIGPMTTWPPRKPGAIYMGGFRAP,-1,-0.7312866,-1,0
B2UQL7,MSIFSSRRQFLKSLGLAAGAAAAGNALPGKAVEIPAGDHLWKSASPAAPRPSGSTYMGGFKAPRLGRIRL,-1,-0.76777005,-1,0
B3PWV0,MPSYRPPKIASSEITPRRIYMRRREFLGAAALGAVALYGAGKASAAALPAVESKYKLDEKPTPLKDVTTY,-1,-0.71547437,-1,0
O34213,MSEHKNGHTRRDFLLRTITLAPAMAVGSTAMGALVAPMAAGAAEQSSGSQTARDYQPTWFTAEEFAFITA,-1,-0.7723286,-1,0
O87948,MNRRDFLKGIASSSFVVLGGSSVLTPLNALAKAGINEDEWLTTGSHFGAFKMKRKNGVIAEVKPFDLDKY,-1,-0.6654614,-1,0
P05448,MTDTLNRRAAMALGLASAAGAALATPALSQDAAPATVRNNVSGFQMHAWRDHFDSLGKPMLVADTFSRAL,-1,0.6084796,1,2
P07603,MQIASITRRGFLKVACVTTGAALIGIRMTGKAVAAVKQIKDYMLDRINGVYGADAKFPVRASQDNTQVKA,-1,-0.6742842,-1,0
P0AAK9,MTWSRRQFLTGVGVLAAVSGTAGRVVAKTLNINGVRYGMVHDESLCIGCTACMDACREVNKVPEGVSRLT,-1,-0.7671608,-1,0
P0AAL5,MSRSAKPQNGRRRFLRDVVRTAGGLAAVGVALGLQQQTARASGVRLRPPGAINENAFASACVRCGQCVQA,-1,-0.67669916,-1,0
P12374,MESRTSRRTFVKGLAAAGVLGGLGLWRSPSWAASGSPALSVLSGTEFDLSIGEMPVNITGRRRTAMAING,-1,-0.71902514,-1,0
P17201,MGRLNRFRLGKDGRREQASLSRRGFLVTSLGAGVMFGFARPSSANQIFPLDRSLPGDGAFEPTIWCSIAP,-1,-0.62962997,-1,0
P18775,MKTKIPDAVLAAEVSRRGLVKTTAIGGLAMASSALTLPFSRIAHAVDSAIPTKSDEKVIWSACTVNCGSR,-1,-0.7524502,-1,0
P19573,MSDKDSKNTPQVPEKLGLSRRGFLGASAVTGAAVAATALGGAVMTRESWAQAVKESKQKIHVGPGELDDY,-1,-0.7531004,-1,0
P25006,MTEQLQMTRRTMLAGAALAGAVAPLLHTAQAHAAGAAAAAGAAPVDISTLPRVKVDLVKPPFVHAHDQVA,-1,-0.7070239,-1,0
P26648,MSLSRRQFIQASGIALCAGAVPLKASAAGQQQPLPVPPLLESRRGQPLFMTVQRAHWSFTPGTRASVWGI,-1,-0.7254912,-1,0
P31075,METTMTRRDFLKSAGAAGAAGLVWSQTIPGTLGALEKQEIKGSAKFVPSICEMCTSSCTIEARVEGDKGV,-1,-0.75140524,-1,0
P33225,MNNNDLFQASRRRFLAQLGGLTVAGMLGPSLLTPRRATAAQAATDAVISKEGILTGSHWGAIRATVKDGR,-1,-0.773163,-1,0
P36548,MSTFKPLKTLTSRRQVLKAGLAALTLSGMSQAIAKDELLKTSNGHSKPKAKKSGGKRVVVLDPGHGGIDT,-1,-0.4637898,0,1
P36649,MQRRDFLKYSVALGVASALPLWSRAVFAAERPTLPIPDLLTTDARNRIQLTIGAGQSTFGGKTATTWGYN,-1,-0.7024213,-1,0
P38043,MSQFSRRKFLLTAGGTAAAALWLNACGSNNSSTDTTGSTSTPAPSGTSGGDAPEVKGVTLGFIALTDAAP,-1,-0.7952088,-1,0
P44798,MKKNNVNEQRRDFLKKTSLGVAGSALSGGMVGVVSKSAVAKEAEMKTVVTAAHWGSIGVVVQDGKVVKSG,-1,-0.64764124,-1,0
P46448,MQVSRRKFFKICAGGMAGTSAAMLGFAPANVLAAPREYKLLRAFESRNTCTYCAVSCGMLLYSTGKPYNS,-1,-0.52548593,-1,0
P50500,MSEKDKMITRRDALRNIAVVVGSVATTTMMGVGVADAGSMPKAAVQYQDTPKGKDHCSVCAQFIAPHSCK,-1,-0.6852448,-1,0
P55669,MTISRRDLFKAGLAAGAALSVPSLLRAQTAVAADKTVRMALENLSVFDPVATTAGISQTHALAIYDTLFS,-1,-0.7647282,-1,0
P63884,MSGSNTAISRRRLLQGAGAMWLLSVSQVSLAAVSQVVAVRVWPASSYTRVTVESNRQLKYKQFALSNPER,-1,-0.69217527,-1,0
P73452,MSNFSRSTRRKFMFTAGAAAIGGVVLHGCTSPTTTSTGTGTGSSTDQAISPLVEGENAPEVTTAKLGFIA,-1,-0.7566254,-1,0
P76342,MKKNQFLKESDVTAESVFFMKRRQVLKALGISATALSLPHAAHADLLSWFKGNDRPPAPAGKALEFSKPA,-1,-0.56205124,-1,0
P77554,MKESNSRREFLSQSGKMVTAAALFGTSVPLAHAAVAGTLNCEANNTMKITDPHYYLDNVLLETGFDYENG,-1,-0.7899397,-1,0
P81040,MNIGRRDLICGLGGLAVGGAMLGLGSVEARAAGQAQPASGRFDQVGGAFGWKPHKLDPKECAQVAYDGYW,-1,-0.7882542,-1,0
P84887,MRWLDKFGESLSRSVAHKTSRRSVLRSVGKLMVGSAFVLPVLPVARAAGGGGSSSGADHISLNPDLANED,-1,-0.61579037,-1,0
P94127,MESKEHKGLSRRALFSATAGSAILAGTVGPAALSLGAAGLATPARAATGADGSVAPGKLDDYYGFWSSGQ,-1,-0.7356063,-1,0
P96465,MLARRRFLQFSGAAVASSLALPLLARAAGKTAASAPTDAALTAATDFAALEKAVRGRFGVTLLDTASGRR,-1,-0.71641695,-1,0
Q01578,MTTGRMSRRECLSAAVMVPIAAMTATATITGSAQAAKNNMNGSTIGKITKFSPRLDAILDVSTPIEVIAS,-1,-0.43154022,0,1
Q01S58,MDKTSRRDLLKLASLAGIGAGLARSQGSSKSMAGVSFKPNGTVRIGVIGTGGRGGSLIENFSAVEGVQIT,-1,-0.78212214,-1,0
Q06530,MTLNRRDFIKTSGAAVAAVGILGFPHLAFGAGRKVVVVGGGTGGATAAKYIKLADPSIEVTLIEPNTDYY,-1,-0.7595254,-1,0
Q07982,MTNKISSSDNLSNAVSATDDNASRTPNLTRRALVGGGVGLAAAGALASGLQAATLPAGASQVPTTPAGRP,-1,-0.5659127,-1,0
Q2IGN2,MARWRPDTAEREATPEALYLRRREFLALGAAGAVGLLLPRGARAGEPTGAALQVARKVDQAGGETPTPWD,-1,-0.6299803,-1,0
Q44018,MQRRHFIARAGIAAATAALGLAAMPAQAQADKFPQRPIRLVIGYTAGGSTDIPFRVLADNASKILGQPVI,-1,-0.71168685,-1,0
Q44292,MTHVSRRKFLFTTGAAAAASILVHGCTSNGSQSATTGEQAPSAAPAANVSAANAPKVETTKAKLGFIPLT,-1,-0.78765637,-1,0
Q51705,MESKQEKGLSRRALLGATAGGAAVAGAFGGRLALGPAALGLGTAGVATVAGSGAALAASGDGSVAPGQLD,-1,-0.7187418,-1,0
Q57366,MTKLSGQELHAELSRRAFLSYTAAVGALGLCGTSLLAQGARAEGLANGEVMSGCHWGVFKARVENGRAVA,-1,-0.5886619,-1,0
Q59746,MSNEETKMRLNRRQMLGTTAFMAAAGAVGAGGALTLSGGTATPARAQETSGSSYEVKPGELDEYYVFFSS,-1,-0.696998,-1,0
Q5LNE0,MAHRWINDLTPADITPRGAWMNRRQVMAGMAGAGLAAFAGSAQAETLEPNSWEEITSYNNFYEFGTGKDD,-1,-0.26414105,0,1
Q60AK7,MRKTSSPRIAPSEITPRDLYHDRRRFMQAAAGAAAAALWPHWLSAGEKLPGVRKTDHVLPDALTPFEDVA,-1,-0.625212,-1,0
Q63Q46,MLIKKTLRAALAGDDIPRSEITPRAVFEHRRRILQAAGAAAAGGLVGAHGLALAAYASPDAAARKLAAPA,-1,-0.7408796,-1,0
Q89BU4,MNRRQLLRGSVAVSAAAVLPRAADAQSGTALTFSPSYVRELARALATKPFAAPDEKLPEALKNLNYDQYR,-1,-0.7559484,-1,0
Q89XJ6,MSDSDNIKGVSRRTLLGTTAAAAGVGLAGGAVVTKDGAGFVSTADAQTKSAAPKAPPARPAVQKTEVAPG,-1,-0.7805522,-1,0
Q8ECL7,MHNIHRRHFLKAAGAVTAGLVTANIALNANASSVAPKPSSGKSVIGLIAPKMEVVRVGFIGVGERGFSHV,-1,-0.7724795,-1,0
Q8GGJ7,MEHQTSRRNFLKIAGSSAAVAGAGLVSGNANAAPAKVNVGASTLPYPITAVGKAKGLKVDAPVSFNYPDA,-1,-0.7367219,-1,0
Q8GPG4,MLRTTRRTLMQGASLVGAGLFAAGRGWALNRLEPIGDTLAEEYPYRDWEDLYRNEFTWDYVGKAAHCINC,-1,-0.3597395,0,1
Q8X6I9,MSNQGEYPEDNRVGKHEPHDLSLTRRDLIKVSAATAAAAVVYPHSTLAASVPAATPAPEIMPLTLKVNGK,-1,-0.36883086,0,1
Q8XAS4,MQYEDKNGVNEPSRRRLLKGIGALALAGSCPVAHAQKTQSAPGTLSPVARNEKQPFYGEHQAGILTPQQA,-1,-0.6994163,-1,0
Q8XQB8,MMSKHPHSPSTPQDETPSVPGRRRFMNSAALAGLATVVACTDKGAPAGSAAATGVAATAEEHTVAGLHPK,-1,-0.19500108,0,1
Q8XT53,MVTRRHLLASASLSATLAALGITPEALAASRVKLGNAAPFNFDALIERARAMAGQPYTPPATAPADILAK,-1,-0.57455707,-1,0
Q8XUX6,MHRRDLLKQLAAGFLALAPGLTPSTASAVSPASAATEPFDEAWLRRRARALAAGPYRKRNTALPPPLAAL,-1,-0.7121538,-1,0
Q8XV50,MLIKTDRWLRGDDIPASEITPQHLFDQRRRLLAAAALGAAGAALSPWAARRAFAASPAPAWLAAKPNPAY,-1,-0.7498721,-1,0
Q9F0W4,MSDKKDQVPGAVEAPRGVSRRSFLGTGAVTGAVLAGATALGAGTFTRESWAAAAKEAKSKIHVGPGELDE,-1,-0.7669905,-1,0
Q9HYL2,MSDDTKSPHEETHGLNRRGFLGASALTGAAALVGASALGSAVVGREARAAGKGERSKAEVAPGELDEYYG,-1,-0.7635551,-1,0
Q9Z4S6,MANLTRRQWLKVGLAVGGMVTFGLSYRDVAKRAIDGLLNGTSGKVTRDRIFGNALIPEAQAQTHWQQNPQ,-1,-0.7900501,-1,0
M1VB40,MEKIADSGPVQIFLSRRKLLAFSGASLTVAAIGAPSKGSTQDVVASNRDSISDFMQLSAFATGHKNLDLN,-1,-0.54078937,-1,0
A6VR21,MNYSRRSLFKKTLIATALSALPATLLAATKQPLVIPPLIESRRGKPVFLGLESAQVKLIDDKLVEVWGFN,-1,-0.6529641,-1,0
A4WAB7,MNRRRFLQGSLAMAALSGTTGLSTLFSRAAFAADSDIADGQSRRFDFSVLQSMAHDLAQTPWGGAPRPLP,-1,-0.7755285,-1,0
B0SVB3,MLIRHAPDLTDNDVTGHGLYLRRRDFIGGAAGLGLMAAAGSASARGLTYGPGFSTTEAPTPKKDITSYNN,-1,-0.70072347,-1,0
P0A433,MQTRRVVLKSAAAAGTLLGGLAGCASVAGSIGTGDRINTVRGPITISEAGFTLTHEHICGSSAGFLRAWP,-1,-0.7649187,-1,0
P0A4R0,MSSFKPSRFSTARLTGDAVTPKSIYLRRREFMIGLGAIAATGAASSAFADPLEAKTTAYKVDEKLTPQNA,-1,-0.31817415,0,1
P0AB08,MDKFDANRRKLLALGGVALGAAILPTPAFATLSTPRPRILTLNNLHTGESIKAEFFDGRGYIQEELAKLN,-1,-0.7068923,-1,0
P16028,MSLVNGRRRTAASVVALTAALTALAALCAPAQAQDTKATSKAAEAAKPDAGTLRVCAAEQPPLSMKDGSG,-1,-0.44205192,0,1
P55572,MTKTVTRAGGASGPQQFQSGGETMKYEITRRRFLAASSAVLAAPAIVTMVRPARAGTTLTLGHGAAPGNP,-1,0.7717889,1,2
P58362,MTLTRREFIKHSGIAAGALVVTSAAPLPAWAEEKGGKILTAGRWGAMNVEVKDGKIVSSTGALAKTIPNS,-1,-0.6850442,-1,0
Q06816,MTKTLAEQPGEGAAPVSPSPSRRALLHGAAGLGALAAGAAVAGPGLAFAAPAGLPLPPATPGITPFKIAV,-1,-0.36329255,0,1
Q20X63,MSSRLPALPLSRRQALLGGAGSAAALLLPGGAQAQTRLQITEGNVAPMPIAIPNFVAGTPADNEVGLGVA,-1,-0.7228549,-1,0
Q28TS0,MLNRRNFIRTTSALAASTALPGYAFGQSGPLRLEITEGVIEPLPFALPTFLAVGGAEDAAADVSRVIAAD,-1,-0.50947416,-1,0
Q3J1R2,MDRRSFITKAAVGGAAASALAAPALAQSAPKVTWRLASSFPKSLDTIFGGAEVLSKMLSEATDGNFQIQV,-1,-0.7237396,-1,0
Q4KHN0,MHRRNLLKASMALAAYTGLSASGLLAARAWAGAADGQAQAFDFEQLKAQAKQLAASQYVDTKQVLPPTLA,-1,-0.6500854,-1,0
Q5FQB9,MSFIPNTEAEALSALFSRRSVLGATAAGGLLATPLAAFAQSGAASGPGEAEITVDQARQEPIPIVVPNFG,-1,-0.71180505,-1,0
Q66BP4,MRDKTGPKFGPYQPDDEAVSPSRRRLILGMGMVSGALVLGGAKTAQAADCRSPDVAGTQDERWQKQPFYG,-1,-0.64524543,-1,0
Q72E84,MALDRRGFLKFIGGATAGILATPVVWKGLDDVSIWSQNWSWIPRNIKGANSYVPTVSKLCPTGIGVRVRL,-1,-0.7645482,-1,0
Q7CQM9,MWTGVNMDSSKRQFLQQLGVLTAGASLVPLAEAKFPFSPERHEGSPRHRYAMLIDLRRCIGCQSCTVSCT,-1,19.924053,20,21
Q8XUU7,MSNRRLFLKSIPIMAAAGAVGMAGLARAANPMVAETDPQAAALGYKADTTKVDQAKYPKHAPDQHCGNCA,-1,-0.5782128,-1,0
Q9FA54,MPAPAAPSARLNRRLLLSAASSSLALAASGLMGLPLRAQEAPADAPPASVPVAAPQQFSYDWLTEEMRVA,-1,1.5560143,2,3
P96956,MKMPILPPLPLASRHLLLASAIALAAGCAGLPDQRLAQEALERGDLATAQSNYQALAAMGYADAQVGLAD,-1,-0.76112926,-1,0
F5ZAY7,MFHNTCGRKGRFARAMGMALAISVTLSGCSTVSDWFADEEELEIRRLKPIDAKFTPSVKWDRDIGDGVDH,-1,-0.6310812,-1,0
C7R5S3,MILGWTQRIFTLLVVVTLLAACADEVVNPPKELADIEEKFSVQSSWVEVIGQGDEEKFNSLSPALWQDKI,-1,-0.6842672,-1,0
E4PKG3,MPVLRDRIPRRGFFLGLALLAALSGCSSTDTFEQPVPVPEIEASVEFERVWSMSVGDGHDGDFLYLAPLV,-1,-0.79918593,-1,0
Q0AE45,MAGNILLLILDYVFHAGSRTLRVCILSLLILLSGCANLSDLGGGHLTDLFSSEEDEVEIDEAEIVALQTL,-1,17.702717,18,19
C6BGE7,MIHALEQGGVARGIAQAARVAVLALAATAVLGGCSLFSSKNKHEPAKLMEVQQVLAVRQVWSVSVGKSGR,-1,-0.6057199,-1,0
D3VI76,MATLLQTSKVMKVAGLSLVVFLAACSSDQRYKRQVNGDESYLETPPLKTLNIPGGMILPLQNGEYDVPSA,-1,1.741078,2,3
Q8K9V7,MSNQIVLGMLMIFLFSSCSVLENKHYVLNNNLNESYFNLNKFKKNYKGMTKEQIIYIFGNPIISDSFNDV,-1,0.07172495,0,1
E1VAU8,MIDQNHDSEEQAQMQKLTRTVTLTVALTLVSGCSYFGVYKRDLAQGNLVTSAMAEQLQPGMTRQQVVNLM,-1,-0.68347275,-1,0
Q661N6,MNKLLLLILFECIIFLSCSGKGSLESEIPKVSLIIDGTFDDKSFNESALNGIKKVKEEFKIEPVLKESST,-1,-0.24351276,0,1
D2Z0P5,MSPAQQLTLPAVIVVASVMLLGCEGPPPGTEQIGYRGVGMENYYNKRQRALSIQANQPVESLPAADSTGP,-1,1.9783013,2,3
P57544,MKTLSLILIFFFLNGCNNPLLNSHGTIATEEYSLILISFIMMLFIIIPVIFMTIYFSLKYRSTNVNQIYK,-1,1.3332591,1,2
Q45407,MFVSIPSIRKTVMSLCAVPLMAACAFAPGMRFDPQRPLDPADNASVPKITQITPDLVRGGQAQVPRENVD,-1,12.064858,12,13
Q66BT9,MYLRKISAPLMTMLLLNGCAYIPHKPLVDGTTSAQPAPASAPLPNGSIFQTVQPMNYGYQPLFEDRRPRN,-1,-0.7274596,-1,0
O67609,MLYLFFALIFIISCSTKVESKKKYTYSFPKTYKEEKPTRGSLFKSPQSAYLYGSVRASEVGDVIYIRVIE,-1,0.23135303,0,1
A1UTU3,MYLVFGIIFTSVIVTSCSYNTKDFNSVPDFSPVRADLGYAPSRTAQTYPLPPRESNYSLYRASGNSFFRD,-1,-0.3389122,0,1
Q89AH6,MVITLLNLNKKHYLLILFFILLNGCSIDKNIILNKKQKQHKIFNLPITHTSKETHNFNYQDNKQSNNNYL,-1,-0.06352782,0,1
P22606,MRRPAILAAAVLLAPLAACSTVKEAVKGPDLAPVGYPAPLAPMQQQYVSAREPAPQAASANSLWRVGARA,-1,-0.7583511,-1,0
Q6LTQ7,MKKVLAGIVILLLNGCAMDPDLAPSDIEKATTTVDAVEGSTEQDSGLIDMLRRREDPQAGDPAWNPIRPQ,-1,-0.7414621,-1,0
P58205,MSRRMSLTALALLLAPAACSTYVEDRASEAWAPVYPVEEAERLDSLPTGGIYSSTSRGLFVSDRRAARVG,-1,-0.57694936,-1,0
B4SIL5,MSPLSNFARTALACAVAALLGGCVIAGDVRPYPTMAPIQPIMPPQAQPTAGAIYAAGPTLQLYSDRRARD,-1,-0.75285864,-1,0
Q2LT21,MNILIQNRLIFLFLILWLWTGCATKPDFTAGEQPLDLTVRPEALPVRGSIWPGESASNMLFADKKARYIN,-1,-0.6644947,-1,0
Q7M7T1,MSGFLLVTLVAALYSGCSVADPQISFKPPEYVEEMPAREVEESFGNAGSLFGQGDNPLFADRRAMKLNDL,-1,9.323672,9,10
P45993,MQKTPKKLTALFHQKSTATCSGANYSGANYSGSKCFRFHRLALLACVALLDCIVALPAYAYDGRVTFQGE,-1,-0.59482515,-1,0
A1K3G9,MRPARRFLAALACVAGALLSACATPTPRAERAVLREVSAQFFLGGRMSASDGNQGASGRIEWQHDTAGDE,-1,-0.8391783,-1,0
Q7WNY6,MSACPAPRSPFRWLHAFTLCLLLAVLAGCVSVPKPMAGAGEDVFSRVGRFAITVTESDGKQQAVQGGFAW,-1,-0.80431193,-1,0
Q83AQ2,MSLISNNEERSLRVRYCIAIALSALLISGCTTLRLPNQSTSVYHQQTWAQRYYDLSRISQWNIDGAFSIQ,-1,-0.73290616,-1,0
Q12QS0,MPVNLNHTLLLCLLVAASLLSGCSSTLGEQYQTLNVSQSKQAKAWELQGKIAVKSPTDKFSTNLYWFHLG,-1,0.24529323,0,1
Q9PA74,MTVYLHDVNRGLGVFLLVVSFLLPGCSSSGGRRASVPVMVDATAQVVEQARQTWLQEHPNWGFHGRAAIS,-1,-0.76961666,-1,0
C6CMD7,MLPLNSVRTHAGRLVPVMLAALFLAGCPSQAPQSPAMQQRVEGKAGASSDYYLQQMQQSSDDSKADWQLL,-1,-0.5808241,-1,0
P45299,MSILLQGERFKKRLMPILLSMALAGCSNLLGSNFTQTLQKDANASSEFYINKLGQTQELEDQQTYKLLAA,-1,-0.608522,-1,0
Q6LME4,MNSMLNFTHKRKSVSRLLAPVALAVILAGCSSSNQQQASASNITAIATDTSANYLIKAESSDGIESIDWN,-1,-0.6086945,-1,0
C3NVZ3,MAMNHHQRRSVPRLLTPIALSIVLSACSTQPSSPDVVDITAQPLLTAQTYLMRADASQGNQQNDWLIMAL,-1,-0.384404,0,1
P02938,MNRTKLVLGAVILGSHSAGCSSNAKIDQLSSDVQTLNAKVDQLSNDVNAMRSDVQAAKDDAARANQRLDN,-1,-0.74323803,-1,0
A0A0K8P8E7,MQTTVTTMLLASVALAACAGGGSTPLPLPQQQPPQQEPPPPPVPLASRAACEALKDGNGDMVWPNAATVV,-1,-0.48378167,0,1
P45682,MDKGEGLRLAATLRQWTRLYGGCHLLLGAVVCSLLAACSSSPPGGVKVVDRNGSAPAAARRTPVTSGQYI,-1,0.81034386,1,2
P33209,MFGSAHGDTTSSDTSGRRPLRLVVLPLLLALSSCKVDLYTQLQEREANEIVALLMDNGVDAVRVAGKDGT,-1,-0.65042204,-1,0
O68937,MNNPLVNQAAMVLPVFLLSACLGGGGSFDLDSVDTEAPRPAPKYQDVSSEKPQAQKDQGGYGFAMRLKRR,-1,-0.5080658,-1,0
Q7VK78,MKHIHKIKNYAMVGGLGVMAVFALNACEQNSGQNNALNNTLQNSQKNGAFVIVEEQNDGSYKVLEEYPSE,-1,-0.5818026,-1,0
P44572,MNNLFALCQRSAVIFSIIFTVVACDKLDSPKPISPQIETQKNTQLESNRVELKRGVYSDLTLQPWQAQSE,-1,-0.13379365,0,1
Q47151,MSLPSIPSFVLSGLLLICLPFSSFASATTSHISFSYAARQRMQNRARLLKQYQTHLKKQASYIVEGNAES,-1,22.610538,23,24
Q0TBP2,MALMVLMALVGCSTPPPVQKAQRVKVDPLRSLNMEALCKDQAAKRYNTGEQKIDVTAFEQFQGSYEMRGY,-1,1.8527782,2,3
P0ABJ1,MRLRKYNKSLGWLSLFAGTVLLSGCNSALLDPKGQIGLEQRSLILTAFGLMLIVVIPAILMAVGFAWKYR,-1,-0.7626884,-1,0
P77211,MSPCKLLPFCVALALTGCSLAPDYQRPAMPVPQQFSLSQNGLVNAADNYQNAGWRTFFVDNQVKTLISEA,-1,-0.7461107,-1,0
G8JZS6,MKKHLIYTGMFLAAIGFSACNEDFKDWADPQSNPQEESAGQLTATFTAGKDASIVMDAATADSVEIAKLS,-1,-0.7319194,-1,0
Q8A1G3,MNKHLHFLSLLWLSMLMAFMTACSDDKNITDPAPEPEPPVEGQWTALTASPDTWDETKRADISYQLLLYS,-1,2.3919067,2,3
B2FHL8,MSLPLRLALLPTLLASASAFAACPAPPPGQPDIRAIGYYTDKAGSVIDPALQQQNKDATAPLDRYAADVA,-1,18.132833,18,19
Q8A1G2,MKTKYIKQLFSAALIAVLSSGVTSCINDLDISPIDPQTGGSFDQQGVFVKGYAMLGVTGQKGIDGSPDLD,-1,9.185158,9,10
Q72EC8,MSRHPMVTRLLCLVFSCLIILACSPAFAGHGAPKAQKTGILLVAFGTSVEEARPALDKMGDRVRAAHPDI,-1,18.37286,18,19
G8JZT0,MKKISNILLAVTFALPLFTACETDNDSNPILNEPDTFTLNTPAYAANNVYDLKNAQTVELTCSQPDYGFP,-1,-0.7028742,-1,0
Q5FRE4,MRHAFRHSVRTLGLLGLLPVLSACNSLAQMSEIGRPPRMTSITDPTLANSYRPVTMPMPPLQAPPDEAAS,-1,-0.65756,-1,0
Q28JK4,MNMRVFIFLIFAAASVSACGRLASVGQTPNLTSPADGNEVFAMNVVPIPDARDVPSRTEGASLWTSGRAS,-1,-0.66584504,-1,0
Q3A5F4,MRTWAVLPILLMLVGCVTQRIVEPQPHSAPIAARQVQPEQPQAPGSLWTEGRGSLFRDNKARRVGDIVTV,-1,-0.22417705,0,1
B7UXA6,MNRLMIVSLLGIATALGGCVNPPPKPNDPYYAPVLPRTPLPAAQNNGAIYQAGFEQNLYDDRKAFRVGDI,-1,-0.68612534,-1,0
Q52950,MRTRITAVLAAGLLAGCQNQAFNEIGRAPAMSPIGSGLQYTQTPQLAMYPKQPRHVTNGYSLWNDQQAAL,-1,-0.70522,-1,0
B5YIX2,MRKLILISLCIFFLASCSELQEVRDIKNAGMPPKYYPEPPQTQVASEGSLWRNKASLYEDKKARRVNDLV,-1,-0.5889604,-1,0
A6L3B5,MEVKSLLMVMATLTIAGCSQNEMTEMNPDTNRTIGLDVYTEVQTRGTETTTSTLKANAGFGIFAYQTSSA,-1,-0.6257429,-1,0
A6LHQ6,MKLLANIFLSGLAILACVSCSKDEDPVLPLEGAKLSVAVKASGTATKAYNPNDVNELEGEAYINNLAVVV,-1,-0.5582392,-1,0
Q51826,MKKTKFFLLGLAALAMTACNKDNEAEPVTESNATISVVLKTSNPNRAFGNAGDEAKVAKLTVMVYKGEQQ,-1,-0.7910347,-1,0
B4E8L3,MKQVRLPSSATVRAACAVAVAALAGCAQIPRDPIIQQPMTAQPPMPMSMQAPGSIYNPGFAGRPLFEDQR,-1,-0.60232544,-1,0
P24126,MQSPATKGTLALAVLAVSLIMAGCASMGDNKPQSARIEANALDAGAAIRAADRDAGWPAADWWRAYRDPQ,-1,-0.61482334,-1,0
Q87JI3,MKWLSKSWAVAVVLLVGCAGRQEFIPPQPNAEEYAPPKLDYTLPDAQSGSLYRHQYTMTLFQDRRAYRVG,-1,-0.7564554,-1,0
Q2IQP0,MSPLTRIALALAASAALVLALTACGPAHVAGYVPKRRDYAVPDASGQDTQAASAGSTWREGRAASMLYTD,-1,-0.4561322,0,1
P75884,MRPLILSIFALFLAGCTHSQQSMVDTFRASLFDNQDITVADQQIQALPYSTMYLRLNEGQRIFVVLGYIE,-1,-0.7138705,-1,0
A7LXT0,MIMNMKNIFYCLLPGLLLGACSNKVYEKTGDSVIVKVQHKETGGPRLVRLQVMGDKLIHVSATADSKFAD,-1,-0.60057324,-1,0
P75882,MKKNSYLLSCLAIAVSSACHAEVLTYPDPLGSSQSDFGGTGLLQMPNARIAPEGEFSVNYRDNDQYRFYS,-1,-0.6282779,-1,0
A6KWM0,MKLLSVLSLSLVLSCTTLSAQKVYEISAFGLKANSSKNASPVLQKALAKIKAEYKEGEKVILRFPEGRYE,-1,-0.28677952,0,1
A6LFT2,MKWYLWGAVVLLYSLFGSACSTEWRYDLSAYGLSPVENVDNAPAMARALEQIREKCEENQTIVVTLPKGR,-1,-0.47098193,0,1
A0M6E0,MRSAFSVFIFIFTIILFSSCDKKRVYDEYESIHEWHKDSLVNFELDNIDSTKVYDLFINIRNNNDYRYSN,-1,-0.6785439,-1,0
B1KD83,MQRRTFIKSISAMMATSTTLGCVSNSLATEKHVSITDFGLRPNSGDDAIPALQKALAYCKKHPGTSLIFP,-1,-0.6903815,-1,0
P0A933,MKKNIFKFSVLTLAVLSLTACTLVPGQNLSTSNKDVIELPDNQYDLDKMVNIYPVTPGLIDQLRAKPIMS,-1,-0.7531624,-1,0
G3XD12,MNRTYDIVIAGGGVIGASCAYQLSRRGNLRIAVVDDKRPGNATRASAGGLWAIGESVGLGCGVIFFRMMS,-1,-0.7595985,-1,0
P58599,MHRCMPLVAASMAALMLAGCGGGDGDTTLSTAAATDTTTLKTAATTSISPLWLTIAKDSAAFTVSGTRTV,-1,-0.7063438,-1,0
P29041,MSERMTPRLFPVSLLIGLLAGCATTPPPDVRRDARLDPQVGAAGATQTTAEQRADGNASAKPTPVIRRGS,-1,-0.8064052,-1,0
P49008,MKRLTFGACICCLLSLMACSQKAKQVQIPEYDKGINIIPLPMQLTESDDSFEVDDKTTICVSAEELKPIA,-1,-0.6903978,-1,0
P14250,MQLKNFYPKMSVLGIATVMALTACGDENTQALFANNPVPGAENQVPVSSSDMSPTSSDAVIDPTSSSAAV,-1,-0.76781696,-1,0
O24968,MIKSWTKKWFLILFLMASCSSYLVATTGEKYFKMATQAFKRGDYHKAVAFYKRSCNLRVGVGCTSLGSMY,-1,-0.4035446,0,1
P57026,MKAYLALISAAVIGLAACSQEPAAPAAEATPAAEAPASEAPAAEAAPADAAEAPAAGNCAATVESNDNMQ,-1,-0.7162707,-1,0
Q48261,MRANNHFKDFAWKKCLLGASVVALLVGCSPHIIETNEVALKLNYHPASEKVQALDEKILLLRPAFQYSDN,-1,-0.70311123,-1,0
P80152,MRAPRCLVVLLVALLLSACSQQLYSGLTENDANDMLEVLLHAGVDASKVTPDDGKTWAVNAPHDQVSYSL,-1,-0.4056031,0,1
E1WAE4,MKKFYSCLPVFLLIGCAQVPLPSSVSKPVQQPGAQKEQLANANSIDECQSLPYVPSDLAKNKSLSNHNAD,-1,-0.7003945,-1,0
A0Q6X4,MKYGNLMMTKKKLLIGMVTISGIVILGSCGKTETVNELLIVDQCNDVRDLCRLELANAQVSRYTNFLGKT,-1,-0.7499056,-1,0
P24640,MLLKRLGLAALFSLSMVGCTTAPNTLAVNTTQKIIQYERSKSDLEVKSLTLASGDKMVYAENDNVTGEPL,-1,-0.7274275,-1,0
Q1QXC9,MKHVSSPHPCAAIASARVWLGLVLVALLAGCASQAPSPDQSRDRGDWEAQIERLQTLDAWSLAGKVGLRT,-1,-0.6944508,-1,0
Q0KEP6,MNRSRRLALFCLGAPLLLQACASVAPSRSFDGDQAAASQQYTGRFSANYVRYGRDEGVQGSFRWEEQGRN,-1,-0.72815156,-1,0
B7NUX5,MPLPDFRLIRLLPLAALVLTACSVTTPKGPGKSPDSPQWRQHQQDVRNLNQYQTRGSFAYISDQQKVYAR,-1,-0.7981106,-1,0
A0Q491,MSKLKIDTKRRFSLLIALVLIISLSSCATTQTNVTAITTKTVFNQETTYHNLLKLKKWQANGVIGIIYDN,-1,-0.79591596,-1,0
Q3IK97,MESKEQHLIRQYFILAMFFLFLAGCAQKRSLETTTYENWKTHLAEQSIWQVEGKLAFISPDERQSANLNW,-1,-0.7619778,-1,0
A4VPC2,MSLLKNLLAPCLALLLAGCAALGPHESVEGPGNTAAWKEHRSHVATLDGWQISGKIGIRAPQESGSGTLF,-1,-0.6559496,-1,0
Q7NQS7,MIRRVLLLSLALLLAGCANEALFRPKPALESAADAPFSVSGRLSANLDGKGHVANFDWRHLPPRDEVAIN,-1,-0.66882825,-1,0
A1JME2,MKRYLSVALAALVLTGCITQPPVEPTTPPVTIEPVTPPVPETPPPVDNVPPPPKMEQSIDWAASVEPLVA,-1,-0.6449137,-1,0
P44833,MKKSFLLLPLSLVVLSACTSNFPAPISDADGNFSPSVIQSVNGSNVGGAWQPEIQKNSLPTTGNMVTPQQ,-1,-0.7370988,-1,0
P55802,MKKATKLLLSILPISSISFLSVVSCSTRNSNAKQPDKKPEKPNEKGPIIPKNPDNKKPTNNNNNSNNNSN,-1,-0.65458643,-1,0
O52727,MKKLKSYVLLVLAVLFLTACVTDQERPTNVKYIEKTDRTWQQHFTQLKQIQGYPALGQLGYISSKERFST,-1,-0.6973239,-1,0
Q1LTH4,MLIPKKYYLLIILLSNCLLASCSINTPNPSNIALMQLTRENNYNLKWHSHKYLVKKINHYRTNGLFAYLS,-1,-0.7390127,-1,0
Q479M4,MRLRFSLLLTVSLLAGCASAPPATLQHRDNIRDFSLEGRFALRVAMPDQAPQSSGGRLSWTHRNRSDRVL,-1,-0.39552793,0,1
B0RUA2,MSQVIRTLALTGLALAGLSGCVSVPRGQGGAAPAVVGQVSESARQAEAARQAWLQAHPAWSFQGRVAISK,-1,-0.69221675,-1,0
Q8Z8H6,MRYLVTLLLSLAVLVTAGCGWHLRSTTQVPASMKTMILDSGDPNGPLSRAVRNQLRLNNVNLLDKDTTRK,-1,-0.105411366,0,1
Q50274,MNKKYFKKYSWVLILSTSILAPMTLASCNHNVAKKEDKTQNDSSNLSNKTNKSDPNDHLKDKDKNVSQDN,-1,-0.6065122,-1,0
A8AHW5,MMKMNRYALVAALAIFLSGCVGQREPAPVDEVKPAPEQPAEPQQPVPVVPSVPTIPQQPGPIEHEDQTAQ,-1,-0.7967954,-1,0
D0Z8F8,MIKRMSGIALAALLLSGCQGLLPRGETPSQPPAPTTPAKPSVVPTPTPPVVTPVPQPPKMTSVDWQGSFA,-1,-0.7764243,-1,0
Q7N395,MRRILFVALSVMFLAGCPSLPPEQPEPPTPVVPVTPSEKPTPPSEKVPEPPKMSAIDWESTVQPLVEQLV,-1,-0.5873461,-1,0
Q2NU30,MKKRALIVLAALVLASCTSRKPASPPAPIEPVPPPVTVSVQPPPPATSEPVPMPPKIKTIDWQASLSPLV,-1,-0.7594246,-1,0
P25894,MKIRALLVAMSVATVLTGCQNMDSNGLLSSGAEAFQAYSLSDAQVKTLSDQACQEMDSKATIAPANSEYA,-1,-0.76891434,-1,0
B2UER8,MAMRFAHALGALMLGAGCALFSGCASLRPANDLFAGTQDADTNITRYQGRFSARYTQNNAEQSAVGSFLW,-1,0.4920028,0,1
D3VIE0,MKRILFVILSTMLLASCVLPEATQQPAPVTPVEPKEKQETTPIEPSEKVLQPPKIQSINWNGIVQPLIEE,-1,16.113445,16,17
A1WVQ5,MTGRWSPRLLAGLLAALVLSGCALLVPEDEREAQYEAFLEERAELRDWSVAGRAALRAEGEAVSLSLRWE,-1,-0.5631141,-1,0
A6W1C5,MTYRTLCILAFTALISACSSRPTGPTTPPPESVSAISKWETSGRVGIRTKNDAVSGNFNWQKDPKTFALS,-1,-0.79315436,-1,0
E0SHN8,MKKYLGIVLMALVIAGCTSRVPQTEQPATIEPAVPTPSKPQLPPSESQPLPTPPKIQVPVLDWSAAVTPL,-1,-0.7518053,-1,0
Q83KF5,MNRDSFYPAIACFPLLLMLAGCAPMHETRQALSQQTPAAQVDTALPTALKNGWPDSQWWLEYHDNQLTSL,-1,-0.79269904,-1,0
Q8X5R9,MINRQLSRLLLCSILGSTTLISGCALVRKDSAPHQQLKPEQIKLADDIHLASSGWPQAQWWKQLNDPQLD,-1,-0.78435224,-1,0
P37636,MNRRRKLLIPLLFCGAMLTACDDKSAENAAAMTPEVGVVTLSPGSVNVLSELPGRTVPYEVAEIRPQVGG,-1,-0.8120601,-1,0
Q9PRA0,MKKNKLTTLALILPITILTPIVIASCTNKTKVKKSSSLDKIASNLKLEYFNNKANTKASSVQKDEIKKPL,-1,-0.7180173,-1,0
A1KSQ9,MKILLLLIPLVLTACGTLTGIPAHGGGKRFAVEQELVAASSRAAVKEMDLSALKGRKAALYVSVMGDQGS,-1,-0.26503426,0,1
P0C633,MFKKFLIFIVPILFLSACATKQDTFAQVNQISKNSQCSSCESPGGFEAKIKGLLYISDVGIQCCANKRTL,-1,-0.7780345,-1,0
Q8ZRN1,MAFKFKTFAAVGALIGSLALAGCGQDEKDPNHIKVGVIVGAEQQVAEVAQKVAKEKYGLDVELVTFNDYV,-1,-0.74393463,-1,0
B2RHG4,MKKYLLYASLLTSVLLFSCSKNNPSEPVEDRSIEISIRVDDFTKTGETVRYERNQGSAAERLITNLYLLL,-1,-0.786106,-1,0
P43262,MKLRLSALALGTTLLVGCASSGTDQQGRSDPLEGFNRTMYNFNFNVLDPYIVRPVAVAWRDYVPQPARNG,-1,-0.77681303,-1,0
A7MMK4,MKKLLVVLLPTLLAGCSYYDAMVERMNTDTLEYRCDEKPLTVSLNKQREQVSFVLDDKMLHLNQGRAASG,-1,-0.7253128,-1,0
Q9I574,MKKALWLLLAAVPVVLVACGGSDDDKQTAQVDYLALPGDAKLDTRSVDYKCENGRKFTVQYLNKGDNSLA,-1,-0.5365433,-1,0
P0A935,MKGRWVKYLLMGTVVAMLAACSSKPTDRGQQYKDGKFTQPFSLVNQPDAVGAPINAGDFAEQINHIRNSS,-1,-0.7802639,-1,0
C5BCE9,MKKVLALALIAPLLISCSGKKPDSNGEEYIKDTNGFDILMGQFAHNIENIWGINEVLIAGPKDYVKYSDR,-1,-0.43206266,0,1
Q47XX8,MTKFTSLLLVIFTTVLLSACDKENDSSSLSRILARGYINVGTIFGPTNYYTTANGFAGFEYELAKQYADS,-1,-0.69161224,-1,0
B2RHG3,MMQLKKRYFALILLLFLWSGCDRGVDPQPDPLQPDVYLLVNARAAHTNGEESINMDAEDFEDRVHSLAML,-1,-0.6834928,-1,0
B2RHG2,MNKRKHMDIRRLIISLPAIMALWGGLASCDKMIYDNYDDCPRGVYVNFYSQTECAENPSYPAEVARLNVY,-1,-0.7882499,-1,0
P81363,MKLNKMFLVGALLSLGFASCSKEGNGPAPDSSSTADTHMSVSMSLPQHNRAGDNDYNPIGEYGGVDKIND,-1,-0.6999433,-1,0
Q08255,MKENSCTACSRRLALFVGAAVLVVGCSSKTDVTLNRDKPLVFFNRQPSDPLTGKVDMAAMNWNDKTYYVG,-1,-0.6214374,-1,0
A1U3J1,MSRFISTFRSSSAQLSIVLAVILATGCSQPTTLQEIREEGVLHVITRVAPSIYYQDREQDTGYDYELARL,-1,-0.7422394,-1,0
Q3SJH8,MPSLKTKGAAGKFASLLLVLALSACSRPAPPPETSGELRVGTRNSPATFYIGHDGETAGFEHDLILAFSR,-1,-0.6954243,-1,0
P41052,MFKRRYVTLLPLFVLLAACSSKPKPTETDTTTGTPSGGFLLEPQHNVMQMGGDFANNPNAQQFIDKMVNK,-1,-0.8101064,-1,0
P0AFV5,MVKSQPILRYILRGIPAIAVAVLLSACSANNTAKNMHPETRAVGSETSSLQASQDEFENLVRNVDVKSRI,-1,-0.72060347,-1,0
Q9KPQ4,MSKRLLSLASLALLFGCAQQPNDRAQQYQQQTFPHILNRADVVESNKPRDYTEFSKQSELVVQGSASMAK,-1,-0.7967246,-1,0
P0AEZ7,MKAKAILLASVLLVGCQSTGNVQQHAQSLSAAGQGEAAKFTSQARWMDDGTSIAPDGDLWAFIGDELKMG,-1,-0.7329065,-1,0
Q0K8S4,MTTRPILSCARAVALLATLGACAAAHAARAPGIDGVRFPDVRAVRYQCDGGKTLSVRYFNSPDNQAAVFR,-1,-0.62683105,-1,0
Q9Z7P3,MNRRWNLVLATVALALSVASCDVRSKDKDKDQGSLVEYKDNKDTNDIELSDNQKLSRTFGHLLARQLRKS,-1,-0.6314168,-1,0
Q07408,MNYRELFTGGLSAATVCACSLLVSGAVVASPMSHEVASEGGVMGGSFYVGAAYSPAFPSVTSFDMRESSK,-1,8.4835415,8,9
P18149,MKKIIKLSLLSLSIAGLASCSTLGLGGSDDAKASAKDTAAAQTATTEQAAAVSKPTAKVSLNKLGQDKIK,-1,-0.7340323,-1,0
P21648,MKKLTLFIGLMALGTTSAWASCWQSNSAYEINMAMGRVVVSPDLPVGSVIATKTWTMPDNNTIYVTCDRN,-1,-0.6591252,-1,0
Q55288,MIRYKGFILFLLLMLIGCEQREELISNLSQRQANEIISVLERHNITARKVDGGKQGISVQVEKGTFASAV,-1,-0.74515843,-1,0
Q8EIJ4,MKKILTLAAIVLAIGGCSGQQAETQATPVNIKSLAGDSAVTDIRPADAMPVYPARGKALERSFTDQPPLI,-1,-0.6388501,-1,0
Q7M963,MKTSKLNFLTLVASTGLALAFLSGCTSNTGTTQSAKLYSEEELGLRKATIYNENKTLVKEFEYSKEPAGA,-1,-0.7539754,-1,0
P45296,MLKRILVIIGLAVLATACSNAPRTVSHQVISENDDIQLTGLINNLEKDNRTGIFHKVRTNRSSALMGDKA,-1,-0.8172896,-1,0
P40827,MSAGSPKFTVSRIAALSLVSLWLAGCTSSSNPPAPVTSVDSGSSSNTNSGMLITPPPKMGATTQQTPQQA,-1,-0.72427833,-1,0
Q8XG77,MKPFLRWCFVATALTLAGCSNSAWRKSEVLAVPLQPTLQQEVILARMEQILASRALTDDERAQLLYERGV,-1,-0.7696759,-1,0
P44585,MRCFRLSRHFIVYLFSLCAILLLAGCVQSRGGFVSKNHVVLAEQNPNTHFEQEVMIVRLSQVLLVGKMSN,-1,-0.76049125,-1,0
Q52529,MNALHRIGAGTLLAVLLAFGLTGCGEKEEVQQSLEPVAFHDSDECHVCGMIITDFPGPKGQAVEKRGVKK,-1,-0.6548864,-1,0
P75906,MLRNGNKYLLMLVSIIMLTACISQSRTSFIPPQDRESLLAEQPWPHNGFVAISWHNVEDEAADQRFMSVR,-1,-0.76428676,-1,0
A3PDP9,MKLKSLLSVFTISIVALTSACSTKNAGPSADPDKLIVALIPDENAATVIQDNQGLKDYLTEAFDKEIELV,-1,-0.7569895,-1,0
D7GXG1,MIKTLKRIPLVFLIAIMACSNSGDNGKDKVEEQEQAQEQGEKKGQGEERDKEDGIDGLQPTFLADQDPKP,-1,-0.80519295,-1,0
P74367,MSFLKNQLSRLLALILVVAIGLTACDSGTGLTGNYSQDTLTVIATLREAIDLPQDAPNRQEVQDTARGQI,-1,-0.7609948,-1,0
P19577,MKLSHLSLAIISAITLAACGGGNDDKPMPQDPDNGALVEQRNEAIKKKATAYLEDKDGKAPALTKDEEAT,-1,-0.75280523,-1,0
P72704,MRILPNISRATWFVGIFFVVNILLTACNQPSANSSAEPSPTETNSPVAQVTTDPYKDYKPRLNGKATVEM,-1,-0.77352935,-1,0
Q87C91,MKVHFAGFTLLCLCTAVTITGCKPSNDNQSTGVSQDANSTTPPSAEQTKSVKISGAGASFIYPLISQWSA,-1,-0.36571187,0,1
P69412,MRALPICLVALMLSGCSMLSRSPVEPVQSTAPQPKAEPAKPKAPRATPVRIYTNAEELVGKPFRDLGEVS,-1,-0.5831301,-1,0
O67235,MERFLGFRTPLGALGVVILLTLILSSCSVKTSYKEKGRVYNGKCPEYAKVWVHYCPTKYAYTDRYQHLSK,-1,-0.67197007,-1,0
O26091,MGLALEKVCFLGVIFLISACTVKKEGVKNLSYKHESLRAYENAKDYDPTTKKAAYKRNFFERHFKRYSDS,-1,-0.2588198,0,1
Q1RJR1,MMNHKFVLLILLIFYCFFLSGCNNSKKTPCSRKHSHKELSKDDPHNLVYKGYYKVGSQYKIKGKTYKPNA,-1,-0.5377464,-1,0
Q9PHM1,MQIKTITLKLSAVSLGALFFSGCLGTSFFSSLDNAQVYYPSNDFKSSPSSSGTKGTMKPYTINGKTYYPT,-1,-0.6396939,-1,0
Q8XBQ1,MRKQWLGICIAAGMLAACTSDDGQQQTVSVPQPAVCNGPIVEISGADPRFEPLNATANQDYQRDGKSYKI,-1,-0.7564601,-1,0
Q9KTF4,MNRIYLYLLIVLILAGCSSPGGRYDMSDDQAPDTPLSVEHIEDAHPQYEPYSFGGNKDYNLRGKSYRIIK,-1,-0.71308386,-1,0
A0A0H2ZFV1,MSKRVRSSLILPAVCGLGLAAVLLSSCSSKAPQQPARQAGISGPGDYSRPHRDGAPWWDVDVSRIPDAVP,-1,-0.74830055,-1,0
Q54313,MNKKIFTLFLVVAASAIFAVSCNNKTTNPTSNSSEKKIVTEEDFKNAIEGLTYKTWAFTGKGKSFNFGSP,-1,-0.66449594,-1,0
Q849R1,MKTHYLSIALSVALSGCSLIPDYQRPPAPIQAGWPQGEAYAKLKAGTHRPSQTRDAELNWQVFFRDPVMR,-1,-0.72183084,-1,0
P21625,MKKLLSILAVFGVSAVGTTSVVACNKTESNNLSRVKTIAAPATVAASTPKAVTKPEIKTALEANVLKAVQ,-1,-0.6458502,-1,0
P0A906,MIKRVLVVSMVGLSLVGCVNNDTLSGDVYTASEAKQVQNVSYGTIVNVRPVQIQGGDDSNVIGAIGGAVL,-1,-0.80220205,-1,0
Q55200,MFDLSRLSRGIVPMALLLLGISACTPSQTSQSIAINGSSTVYPITEAIVADFSGGKKGVDIDVEFSGTGG,-1,-0.7832257,-1,0
Q2EHL7,MFTIKKLTLTIVVATTLTGCANIGDSYRASLKNYKQYEEITKQYNIKNDWWKLYKDAQLNRVVEKALLNN,-1,-0.80191934,-1,0
Q46999,MRKNNTAIIFGGLFFSCSVMAANGTLAPTVVPMVNGGQASIAISNTSPNLFTVPGDRIIAVNSLDGALTN,-1,1.0225387,1,2
P32885,MKMKKLMMVALVSSTLALSGCGAMSTAIKKRNLEVKTQMSETIWLEPASERTVFLQIKNTSDKDMSGLQG,-1,-0.7974172,-1,0
O07950,MKGKTVSAALVGKLIALSVGVVACTQVKDETVGVGVLSEPHARLLEIAKEEVKKQHIELRIVEFTNYVAL,-1,-0.55798125,-1,0
Q01305,MGTRVRFSFCGIAGVCLLALGFLVSCSLQSSRSATKKSEARRTSYRIGLMTSTGS,-1,-0.56560147,-1,0
P55405,MRKLLISFVTVAILSGCQTAEDGLTTSSTPTTVTGPAASAIAGDMASRLAEQIGPSATMTIKIEKDSSDF,-1,-0.7945633,-1,0
P29721,MKLKSLVFSLSALFLVLGFTGCKSKAQAKAEQEAQERKAFMAENAKIEKRLMQAKNAATEAEANVYYPEK,-1,-0.6637858,-1,0
Q8CVD0,MHYKKSIIGIAVTATAIIAGCQVTHQIVKSQGTAQGKHGEVQVETTFKDGHIVAIDVLKQKENKVLAGAV,-1,-0.8009364,-1,0
P70900,MRKRISAIIMTLFMVLASCSNQLEAEKLAAESKNTFFDSLVKIGQGFQDIFGILEMQLGDALGFNAVKSG,-1,-0.7187021,-1,0
Q49536,MKKSIFSKKLLVSFGSLVTLAAIPLIAISCGQTNTDQSQQPGSGSTTGGQSGTTTGTDSTTGGQTGSESG,-1,-0.79147565,-1,0
Q2YJ77,MKKVILAFVATAFLAGCTTTGPAVVPVLDGKPRVPVNKSVPAKPPLAQPNPVDTYED,-1,-0.7582325,-1,0
P32779,MRKRISAIINKLNISIMMMIVVLMIGCGQQAVEAGKDGAAAATGGRSLSEVLMEVGKSAENAFYSFMALV,-1,-0.77249324,-1,0
P17797,MKYCLLCLALALGGCQTNDKLASCKGPIFPLNVGRWQPTPSDLQLSNVGGRHEGV,-1,0.3409395,0,1
Q6G2B3,MMRILKTLFLAFIAAISCYTTPSFAETAPVSARKDNRIRFVNYDPYNVTKIIGSIRSSVQLEFADDEEVT,-1,-0.7739761,-1,0
Q59675,MKKIQQLLMLSLISSTLIACGGGGGGGSTPTTSSSPQSSSPASTPSSASSSSIISSSSLSSSLSSSSLSS,-1,-0.6072476,-1,0
Q04976,MKKIIILLTTFFLLSGCTIPRAVFKSSLINQDDPRYNLVEVTPTLKLSAPDTVPKTIVDPVFAANNWHWT,-1,-0.7310426,-1,0
Q9KL83,MKQVIKLSLLCSALWLAGCGDETNSSGASTEVVYESYIQQALQRDTTIKFALSGKDANVPLPSFALMNAK,-1,-0.7876655,-1,0
P75610,MVKVWKIGFGVFLPTALLFSACSFKDYIPTPSFRKDFSTENNFVKNKVPGKDDIYSKFYDLTFSLNFVNN,-1,-0.74416167,-1,0
P47341,MKLKFYKLPLITTAFSFVFLTACSTPQSSFFLPAQTTISTLKINGMENKTGYFLETQRSRGSYNPTASLT,-1,-0.7866608,-1,0
P75595,MQFKYGALIFSGFLGLSIVLASCGARGKFDQVDDGKIKLASSLTSRSASAALQKVVEKYNKVKGVNDYPI,-1,-0.70509315,-1,0
O67301,MRRIGAITALSLPVLLSLLYSCGTGGSASKEEILSKKEHNPEPNIPLECYTDTGVVKLGKAIANPCYVCH,-1,-0.6657025,-1,0
Q9CP96,MKRIWVSLMIAITACSAHAKRVTCKHFATQAEAQAYMEKYKAYHLDGDHDGEACECLLGGSSHGLARCR,-1,-0.73572516,-1,0
P75505,MRKKKFLSRFSFSSLFLLCGTLLSACTGIQADLRNLIKETTGKDIDLSKAIKTKEGKKNIIASLKKSYEV,-1,-0.77608824,-1,0
P33276,MGLSRKKIFTWPLLLTGMAVVSTTFSSCSVFNFFSNLPTTTDNNNYGPTVQNLSAFLPTSDYKKIYDLSF,-1,22.236393,22,23
O51025,MNKKFSISLLSTILAFLLVLGCDLSSNNAENKMDDIFNLEKKYMDNSNYKCLSKNEAIVKNSKIKLGVNN,-1,-0.5683495,-1,0
Q4UNB4,MNKNIFITLLISSLLLLSGCTGDTCIDPDDFGFIKFNVSSRYNPEEITSRQEGDQVAPWRDSAYKVNGYP,-1,-0.7329328,-1,0
P47395,MKLYRSLKAALLPGICTSILLASCASTNTYQDQRNALISLASNRDTLIANAKKSKEEVQKEVTKMNSSTS,-1,-0.7745835,-1,0
Q9CJU4,MNWKAVLIFSVLGSLASCASYSEHAVQRIEAGKSFAVTGNTKRINTMACQDNDDWYLDGYRVGKSFREHQ,-1,-0.5000646,-1,0
P47563,MKLKKRYLLLGSTLTVSAALILSACASSQLNKGVFFTSSSADLLKNNSVPLSMFNVSPTSSFFGNAYAGL,-1,-0.81160074,-1,0
Q9Z8J4,MDAKMGYIFKVMRWIFCFVACGITFGCTNSGFQNANSRPCILSMNRMIHDCVERVVGNRLATAVLIKGSL,-1,-0.75646055,-1,0
O83276,MWHLRCSNWRGSGVFGMCFSLSGCVMGQWCVSRAIVRGHTQGGAVREVVRELLLGPQHHGYARLVDPAVR,-1,-0.39591265,0,1
P47549,MKKLLKKSKFWWFLLCGLSVSTILVACSTPTNSALQTVFSPTSTNFFHGQKGSLKEGLITALKTPSANKH,-1,-0.66203415,-1,0
P43988,MKTISKQLSAVIFPFIFSACVSQSASSLNHQTAAKARVELALSYLQQNNPQLAKINLDKALQHDKNYYLV,-1,-0.73715544,-1,0
P47652,MLKFRNFFKLTLLTLASAFFLSGCANINLISAVGSSSVQPLLNKLSSYYVLNENNDNDKLVEISVQAGGS,-1,-0.7997949,-1,0
Q9HWA1,MKALIGIGLCAALLGGCAALPGRDGPRECSQQLGQEQELQMNMVRDMIREGRLHAALANLESMPPGLLDV,-1,-0.72551024,-1,0
P55428,MITGKTISLPLSVIACLGAGASQAAACANQTDCLKSASAKVSQTLTPKVVPVFGDYPKLYIHDSAANEDY,-1,-0.5617071,-1,0
A7LXT4,MKSIYKYLDTRLFLIGLLVLPFLAVVSCQNDDDDAIPVIHYIRVTDPAKADSTFTDVNPGTMIVVVGEHL,-1,-0.58641434,-1,0
P47678,MLKKQFWTKAGIISSLMVLGSLITACSNLSSGTNFSSLNQLRNSFSKNSELNQDKKELVTSLRDSFEVDS,-1,-0.76656234,-1,0
O83077,MQRCSVVAALAGVVFLAQACSLSTPSRITHTDKLPVVVTFNALKELTQMVGGEKIHLVSIVPDGVDSHDF,-1,0.9711163,1,2
Q9CK30,MQTFSKLGFLCLLSFGLIACDQITQFTTTSNSTNQTKAPAVALDPKAEFHLFIDFQNANNAKIAALNHEI,-1,-0.7052813,-1,0
O67672,MKGKILFALFLSAGVIACQPASQAAKQQEVKVAKAETKTKKKESKAEKFRKALAAQDKWQKACSNPVQIA,-1,3.5239763,4,5
P75056,MKKQLKYWFSLMGLTMSVGLTACSSNQFVFANFESYVSPLLLERAEAKQPMTFLTYPTNEKLINGFANNT,-1,-0.7622366,-1,0
Q92JJ0,MIKKIIFGIAILLSTSCFANSTTSDGSKKDAAKTNDITTQKIIDDFSAYAGTIKPEVREEIQKYRVAIVK,-1,-0.7580697,-1,0
P75265,MKGFSCSRPGYLTGLLLLAVAPILTACTRDYTTKNEFQLTTAQQAKLKPATIEYWRDGDTPEINYASEER,-1,-0.7278638,-1,0
P64655,MRISLLAVILALLFVACHETKKQILQNEADSTPSEKTIWQPEQK,-1,0.13679747,0,1
P47551,MKRFLHRVKWPLLLSSIAVSLGIVAVACAQPNSRTIENLFRPSSAFTDKNDGSINATLYKALENREGLTQ,-1,-0.7108059,-1,0
P43782,MALVNKIKTLSSVGILAATLFLAGCQAQSNILAFTPPAPSASMNVNRTAVVSVTTKDSRAIQEIASYTKH,-1,-0.63557017,-1,0
P0C6F0,MKIRIVSLIVLGFLIGCKHESIITPTVPADGSGGNALNPGLVGGYLPDIGVPDPIISLSMTLDGNLKFDS,-1,-0.6661864,-1,0
P50928,MKLLSKIMIIALAASMLQACNSPGGMNKQGTGTLLGGAGGALLGSQFGKGKGQLVGVGVGALLGAVLGGQ,-1,-0.66120344,-1,0
P0CK95,MNKKFKYKKSLLAAILSATLLAGCDGGGSGSSSDTPPVDSGTGSLPEVKPDPTPNPEPTPEPTPDPEPTP,-1,-0.77129173,-1,0
Q9RGX8,MYLIYLRLVFCCALLLGCGDNSKFDSATDLPVEQEQEQETEQEGEPEESSEQDLVEEVDWKDIPVPADAG,-1,-0.68049777,-1,0
P75820,MRRFFWLVAAALLLAGCAGEKGIVEKEGYQLDTRRQAQAAYPRIKVLVIHYTADDFDSSLATLTDKQVSS,-1,-0.77640796,-1,0
Q9JTB8,MKRQALAAIIASMFALAACGGEPAAQTPAASAEAASSAAQTAAETPAGELPVIDAVTTHAPEVPPAIDRD,-1,-0.7967093,-1,0
B5XP00,MDMTFFRAALLGACVLLSGCDSATTPASPASTATVLDGKTMGTFWRVSVIGVDEAKAEALRAKVQAQLDA,-1,-0.82445943,-1,0
O84080,MGKFFASYLLILAPFFLQSCSAPSRTTLEGVRMTIPYRIVFGEALSPDAFQQAQKEIDRVFDHIDQTFNN,-1,-0.6595853,-1,0
O83774,MKSSCVYWRIGVLVCILCGVGSCGGRARVREYSRAELVIGTLCRVRVYSKRPAAEVHAALEEVFTLLQQQ,-1,-0.6926888,-1,0
P44550,MKKLISGIIAVAMALSLAACQKETKVISLSGKTMGTTYHVKYLDDGSITATSEKTHEEIEAILKDVNAKM,-1,-0.7746627,-1,0
P28607,MQKISIIFNLFLSLGCLAFTFNGSASETKNEWITLGTMAGPIPNAKHSQPANAMLVNGNTYVVDAGDGTA,-1,19.730461,20,21
Q50327,MKLRATFVFKTTLVALSFALFALFLVSCTENVKEIKSESVINELFPNLWVFLAHLLAFVILLFLLLFLFW,-1,-0.6472534,-1,0
P33256,MWSTRVKKLLLLSFNFLIISAIVSSCSIPEELQAKTIVNEFFPNFWVFVAHTIALSIIILLGIFLLWKPT,-1,-0.7342229,-1,0
Q9PR09,MKLNKKHLVAILSVLSLSIIVVPLLTSCTGDIPELNPAEIINTLFPNVWVFIAQVIAMCVVFSLVLWLVW,-1,-0.7412034,-1,0
Q5NIB1,MKKLLFITAPLLLSVLTASCSKSNVPPPTPLAEKPPRETFVKVIWKRKTGNGNGGLANYNVAPAYANDTV,-1,-0.71345073,-1,0
Q15SZ5,MTTKFFIGTAIAVSVLSACSSLEERQIASGNFEYTKQQPGHDIQVPADVDRPNFSQAYKLPALDADAPRN,-1,-0.73991686,-1,0
B7VIM1,MKYSHQLVIGSLAVFVLTACSGSPTQRRQAKDDFEYLETPEFSQWQLPEDAQPQFYPNFDIPSGEFSGGT,-1,-0.7715139,-1,0
Q9KU21,MKYQTLSGLLALSLLFGCSSSPDVVPDVPPSQLYSEAQTALQSGTWLTAIEKLEALDSRYPFGAYSEQVQ,-1,-0.7363777,-1,0
P44057,MQVKTLLGATFLALSLASCSTVEKVVYRIDVPQGNYLEATTVAQVKEGMTAQQVQYLLGTPVLVDPYNSQ,-1,-0.61129206,-1,0
Q63UT0,MNLLKRYAAPVACAAAVLVFAACSSTKDARRVPTPLTEFKPVLDVQQVWTASVGKGGRYSFSPVAVGDAV,-1,-0.64494777,-1,0
Q32D50,MQLRKLLLPGLLSVTLLSGCSLFNSEEDVVKMSPLPTVENQFTPTTAWSTSVGSGIGNFYSNLHPALADN,-1,-0.7307612,-1,0
P43973,MKKIILNLVTAIILAGCSSNPETLKATNDSFQKSETSIPHFSPLATGGVQLPKADDSYSLPNIEVKKGED,-1,-0.7665341,-1,0
E6RM71,MQYWIPKALAVSVLVSLSGCSVFTSDAHNERNYRAHEPVKAPASLSQPAQDPVYKMDVGQYDNNPEATNY,-1,-0.65686536,-1,0
Q98KC1,MFFKRVGQSKAPQRSVLLALSLVVPSLFLSACMSSEKDIDLSKYVDQTEPADVLYNQGLANLNAGRLDEA,-1,-0.75825894,-1,0
P22236,MRNYPLKAVCAVLMLGLSACSSLPTSGPTDSAVLEINQGADASELAAKVNVIELNESLVQQIYAAQQSQR,-1,-0.75204504,-1,0
Q9ZDY1,MKLTKLLSALLVIGLVLGGCKSKKDSNDIVAPIATLYNEGIILLDKKKYKKAAEEFGKIFYQHPGNEMTP,-1,-0.74892807,-1,0
A7LXT7,MEKQSFSDGLFSPLGIKRVIFMLVLLTTSFISCSNSDEKGGSLEVAQEYRNLEFDARGSRQTIQIDGPAE,-1,-0.7398061,-1,0
Q5X521,MKIRILVLILCALTQGCTYVDDYMLGKDNTPQPKELKEIQPKVKMAQSWTTPVGKAHKTNEYLNIKPAIR,-1,-0.5546487,-1,0
Q9HXJ7,MVQWKHAALLALALAVVGCSSNSKKELPPAELTDFKEEVVLSKQWSRSVGDGQGDLYNLLEPAVDGSTIY,-1,-0.21189328,0,1
Q8P980,MMKQVDMYKRVALIALMGMSLAGCSTVKGWFAGKDAAAKKAQEPAELVKFEPSVKVDKLWSTGVGKGEGH,-1,-0.7793609,-1,0
A1SVX3,MSKFYKSGRVTTAVIVALSLSACARFDARTQANGDFDYVQTPRGEHYQTAHFTQNEARDIYDIPALTEQQ,-1,-0.7747617,-1,0
Q9L7A6,MRKLNSLVSLVLAGLLVIGCSNQNQTEQEILSAQALYTQAQTQLEKGDYASAIASFEKMGSRNVQANLFG,-1,-0.71149385,-1,0
O25930,MRLKHFKTFLFITMAIIVIGTGCANKKKKKDEYNKPAIFWYQGILREILFANLETADNYYSSLQSEHINS,-1,-0.7691905,-1,0
Q87AR6,MIQRPTFFSPIHLLAVLLATFILITGCHRETKKNADDGMPVEHLYDKAHTLMKKGNWAGAELSFKRLIAQ,-1,-0.68860984,-1,0
B1XT70,MNPILKGVYSPARLGVVALTLFGILGVTGCSTAVDETQRAWMNKIFRPYVPDVVQGNFISSEQYAKLQLG,-1,-0.63380504,-1,0
C7RSI4,MNKLNSVVVARGAVAVLLIGLAGCTGSLLEPKKIEYKTASANKVPTLEVPPDLTSPTRDDRYAVPDTSGK,-1,-0.7516614,-1,0
Q50985,MKKILLTVSLGLALSACATQGTADKDAQITQDWSVEKLYAEAQDELNSSNYTRAVKLYEILESRFPTSRH,-1,-0.7058054,-1,0
Q0A984,MMLLKRCNRRALVALAAVLLLAACGGARELPDLSDVGDGVATETLWTASTGSGSASSAYALVPAVEGGRV,-1,-0.80209947,-1,0
B3U538,MNKYFTCYVVASLFFSGCTVQHNLINETQSQIVQGHNQVIHQYFDEKNTSGVLVIQTDKKINLYGNALSR,-1,-0.7063483,-1,0
P77330,MKKMLLATALALLITGCAQQTFTVQNKQTAVAPKETITHHFFVSGIGQKKTVDAAKICGGAENVVKTETQ,-1,-0.71178675,-1,0
P39297,MVSRKRNSVIYRFASLLLVLMLSACSALQGTPQPAPPVTDHPQEIRRDQTQGLQRIGSVSTMVRGSPDDA,-1,-0.7800822,-1,0
P97245,MKLRASVLIGATILCLILSACSNYAKKVVKQKNHVYTPVYNELIEKYSEIPLNDKLKDTPFMVQVKLPNY,-1,-0.7670196,-1,0
P0CL65,MFKRFIFITLSLLVFACFKSNKKSIKSDKVVVGVLAHGSFYDKGYNQSVHDGVVKLRDNFGIKLITKSLR,-1,-0.7635318,-1,0
Q9S142,MKLGRYSLFLLCPLLASCSGNGFYKDNLGVIDKNILHADTSLLKSKNKEHYKSSDMVSKTDSIYIGNSSF,-1,-0.7573851,-1,0
A7LXT3,MKIVRYIALFGILSGLAVACTPSTSVIPNDAIRLNQLGYYPNQEKIAVVDSGKVEEFVIWDAVSGEQVFV,-1,-0.70684403,-1,0
C7RCP6,MSTLNKYKTLIIISSLAAVSSCSWFSAKDGTEDIDDRYMKSQQDLELQVPPNVKQIEVQDRYRVPEGVII,-1,-0.7137587,-1,0
Q9A6U9,MLRIFQGRPAVTIAAVLVAASVAGCAGKAKKPTLVYEERPVELLYSTGADRLDRGNWNEAVDYFREVERQ,-1,-0.72903097,-1,0
Q46670,MKKLAIVFTMLLIAGCSSSQDSANNQIDELGKENNSLFTFRNIQSGLMIHNGLHQHGRETIGWEIVPVKT,-1,-0.76748085,-1,0
Q8ZQX4,MKKILLIASMTAGLTACASSPAPEEDSRLKEAYSACINTAQGSPEKIEACQSVLNVLKKERRHQQFANEE,-1,-0.7283182,-1,0
A1VXG4,MQKIIVFILCCFMTFFLYACSSKFENVNPLGRSFGEFEDTDPLKLGLEPTFPTNQEIPSLISGADLVPIT,-1,2.3592348,2,3
O06522,MKKFLPSLLLMGSVACSSNQRMNDYSQPESQSDLAPKSSTIQPQPQPLLSKTPSMSLNLLSSSGPNRQVL,-1,-0.7551311,-1,0
Q9RFY6,MRLLFFLLITLLFAACSSTPKVHQPKHSSKTEKDLGIGLSPTPPPNERIPGEKSRAMLMEMEGREIPVRI,-1,0.8157293,1,2
Q8Z6A7,MKKPVFFLLTMIICSYISFACANISDYKVMTWNLQGSSASTESKWNVNVRQLLSGTAGVDILMVQEAGAV,-1,-0.52723944,-1,0
P0A204,MPRLLILVAVLLLSGCLTAPPKQAAKPTLMPRAQSYKDLTHLPAPTGKIFVSVYNIQDETGQFKPYPASN,-1,-0.25094625,0,1
Q749L1,MSRKVTKYSAVLAVSLFAAALAGCGSENKEGTVGTGPGGVATVGDTACVQCHSAVVDPLTGESIITQYTR,-1,-0.74722135,-1,0
E7DDH2,MQKRMLGGMVAGALACFQVQAAQFQCQDDVKPAAISAEEQKLVDQFWAESLVYLEQYLKALETPTGQCKD,-1,0.7157031,1,2
P0ADB7,MVKKTIAAIFSVLVLSTVLTACNTTRGVGEDISDGGNAISGAATKAQQ,-1,-0.75475407,-1,0
B5XQ85,MKLRWLLILVVFLAGCSSKHDYTNPPWNPEVPVKRAMQWMPISEKAGAAWGVDPQLITAIIAIESGGNPA,-1,-0.77810216,-1,0
Q56030,MTLLSGKTTLVLCLSSILCGCTTNGLPTPYSINLSFPVITQNQINSGGYYINDAEQIRTTDGLCLDAGPD,-1,-0.7048271,-1,0
Q56032,MNKIHVTYKNLLLPITFIAATLISACDNDKDAMAEAEKNQEKYMQKIQQKEHQQSMFFYDKAEMQKAIAN,-1,-0.7628446,-1,0
Q9JYI8,MNTIFKISALTLSAALALSACGKKEAAPASASEPAAASSAQGDTSSIGSTMQQASYAMGVDIGRSLKQMK,-1,-0.7401873,-1,0
A7M4E1,MKQYKLMQVALLAILLFGWAGCSQNEEEVPGNVRNGIVLNVTDTGIISNEPSTRTEDTGFVTTFTQGDQI,-1,-0.5353642,-1,0
O08437,MNNFLKVSLLAAAVAVSLTACQKDEKTAANTAEVKAEASKPAEAPKAEAKSFEEQSGYAIGLSMGRYIAN,-1,-0.7320639,-1,0
Q47I20,MKRLVLISLVLAAGCSTVPPTNVHQPMTARPSPRFEMANGNGSIYQAASSRPLFEDRRARFVGDTITVKI,-1,-0.7082324,-1,0
Q5LWX7,MMQKCLSPKTLIAALVVLSACGRADHLGKAPSFTPNTESPEHVAMLWPGLPLHTQPQRSVDRASLWSGGQ,-1,-0.7622318,-1,0
Q7NXC0,MTLARLAPLAALLLAACAQFQPPPPEPDPLPDLMRQQTSLPQGGGVFTAGGSLSLTSDNRAFRPGDVLTV,-1,-0.4370251,0,1
Q485P0,MKNKNRLNTIKLLSISLLIAVTTACSNTVELSKALPNDPDFAPIMPEEEEERIVPSGSLFKPHYVNNIYS,-1,-0.78438044,-1,0
O32388,MKMKYFHHPSGLLPRLLLLLLLTMGAVACTKEDNPDQPTSDEVATVKMSLDDVEMRGGDLYSGEDLIKKV,-1,3.3585708,3,4
A8IPJ4,MKPVILATASALLLAACQTNSYDSLAYGPTLTPVGQGLEAGRMPVPQPFQQAKERTFRSAYNLNSQSMYR,-1,-0.4909058,0,1
Q0AN96,MIRKLAALIVAAAALQACAVSDRLSYVGQTPPMTPIQNPADLAGTGPSQLPMPMPRMPQQRYATNSTANN,-1,-0.6905909,-1,0
P11460,MFKSTLNIAVAIVCSSLVTLTGCEPKVAQSQVIQPLETPIVIEHNLGQTVISNRPQRVAALDMNEVDFLD,-1,-0.61035746,-1,0
B2RH58,MRTNRILNIICPPILFLLVGFLFGCVREDIESDMNETSSLFLQVQPYNQRSEEGGVAAYDENTIERLTLV,-1,-0.66972286,-1,0
Q89F32,MKNLILILPLLMLTGCVGDPADALTGPRLSPVGSGLRTQADPIPVTPRMRTPVSYRSTWDDGTDLYRDPR,-1,-0.34344646,0,1
A0PA81,MNDAKKYIVSVLILLVAGMFGGCIKEDYSDCPRPFRLTVRAWDADMQDITETGAVQRVVIFVFDETGRRI,-1,-0.71369314,-1,0
Q5X5U0,MNRLNIAVSCLATALLFGCEALHPPAPGDNPDYAPTYPVTPDPKELRKVSGAIYSSETALPLFETPRARH,-1,-0.6205437,-1,0
Q31FL3,MTRINTNTQKNNNTKFSKLILGVMVSSIVLSGCSATPERMEKFSYEPNYPMNIPKKTVPKNGSLYQSGDA,-1,-0.58604485,-1,0
Q82XG6,MRNRGHLVLPVLIVMICVVSGCAITPTPKVQQPMSVRPPDLPVIPPSQTSGGIYQAVFDYQGRGRYIPLF,-1,-0.722841,-1,0
Q52081,MNRLLSVFALGGAVLLAGCVAPTPSPTTRTMRRCCRAPRCRQRPTTVRSTRPVSSRTCTATARRSGWVTS,-1,-0.7341809,-1,0
A7LXW1,MRNTRYGFLVLLSSLLMLTGCSRRDILDDYPVSGVDIKLDWDGVTDQLPEGVRVIFYPKNGDGRKVDKYL,-1,-0.730747,-1,0
B2RH59,MKSKSIIAQLLYVLIAFMAVSCVADKSEPCPSGEPTRVSGSIVSLEHHGLRGASADKENSVERLELWVFD,-1,18.736912,19,20
P43961,MKKIILTLSLGLLTACSAQIQKAEQNDVKLAPPTDVRSGYIRLVKNVNYYIDSESIWVDNQEPQIVHFDA,-1,-0.6259082,-1,0
D0JWX6,MKRYLSLALAALVLTGCVPPDSVTPTPPVTIEPVTPPDVEVPPPVDTVPQPPKVQSIDWAVSVEPLVAQM,-1,-0.7193854,-1,0
Q0AC01,MRRGRLLIAGLAALVLSACATLPEPVDDPKARYQEAVERLRAQTDWDASGRAALRTADDAGSLSLEWRQR,-1,-0.7922978,-1,0
C4K7Y9,MLIFKICFYRLLPLSVLLLAACSALKAPESSSVLKNHIASDEWQEYQHQLKQIQQFQIQGSVAYFSDEKK,-1,-0.66954046,-1,0
A7MY80,MTLRSFLILLLSSIVLAGCSSVPESVTSVEWQAHEQRLETIDNFQATGKLGYIGPDQRQSLNFFWKHSSA,-1,-0.56404525,-1,0
D4I110,MSWIRIRRSGVLLLALVLSGCINQQQQPQPAAPVEPVTPPVNVPQPPKAEPGQNVPPPPKMQPLNWSATV,-1,-0.036937464,0,1
D4GC59,MIRSVNRTGALMMALILSGCVMKQQQPAPVEPTQPVEPVQPVPQPEQPIPQPQPVPQPPKLVTINWDASV,-1,-0.69145507,-1,0
P0A0V1,MKNQVKKILGMSVVAAMVIVGCSHAPKSGISKSNKAYKEATKGAPDWVVGDLEKVAKYEKYSGVFLGRAE,-1,-0.7717378,-1,0
Q3SLR7,MRRLAVIASLAWALGGCATVAPPPQAAIPVPLADAWTLQGRLGVQTERESLSGQIRWQHGGGVDQVLLTS,-1,-0.6987362,-1,0
Q57457,MINSIKTLLLIATLAILSACGWHFQQSVTMPSEWRTLALESDDSYNDFTVIMRRKLQENQVNVVNLEQNI,-1,-0.7188494,-1,0
C9Y1J4,MLNRMYRYALLATVALALSGCILPGEQKPAPVEEAQPGTQQPTQPVPPPTQPVPTVPSVPSIPAQPGPIE,-1,-0.77083975,-1,0
C4K8P0,MKKYLLSASIVFLLASCAQPPAKIGRPSKSEPSTVSTDSPEGISSESAEIGIVPLTPKIKSFDWSVPMKP,-1,-0.7936068,-1,0
A8GD35,MKKYLFVALAALVLTGCLSRPPEPEQPQPPVTVEPVTPPVVEEPQPPVTEPVPQPPKIQQLDWLSSVQPL,-1,-0.35972473,0,1
Q82TQ2,MACRSWVLGILLVLVGCAGPEVHQGEVTTVVIQPVQEQADIANEPFVLTGRLAVNARQHRFSGGIRWQHT,-1,-0.26166168,0,1
P43505,MAFYASKAMRAAALAAAVALALSSCGKGGDAAQGGQPAGREAPAPVVGVVTVHPQTVALTVELPGRLESL,-1,-0.7347326,-1,0
P0A1X3,MIRHGSNKLKIFILSILLLTLSGCALKSSSNSEKEWHIVPVSKDYFSIPNDLLWSFNTTNKSINVYSKCI,-1,-0.7621762,-1,0
P23898,MRFCLILITALLLAGCSHHKAPPPNARLSDSITVIAGLNDQLQSWHGTPYRYGGMTRRGVDCSGFVVVTM,-1,-0.27244624,0,1
O68481,MRTRLRFVLVAAALALLSACKEDVAQSIVPQDMTPETLGHYCQMNLLEHPGPKAQIFLEGSPAPLFFSQV,-1,-0.6605386,-1,0
P0ADB0,MFVTSKKMTAAVLAITLAMSLSACSNWSKRDRNTAIGAGAGALGGAVLTDGSTLGTLGGAAVGGVIGHQV,-1,-0.74737126,-1,0
Q09089,MKKYLLGIGLILALIACKQNVSSLDEKNSVSVDLPGEMKVLVSKEKDKDGKYSLMATVDKLELKGTSDKS,-1,-0.7545885,-1,0
Q09090,MKQYLLGFTLVFALIACAQKGANPEQKGGDADVLNTSKTEKYLNKNLPSEAEDLVSLFNDSEIFVSKEKN,-1,-0.7591256,-1,0
Q07337,MKKNTLSAILMTLFLFISCNNSGKDGNTSANSADESVKGPNLTEISKKITDSNAVLLAVKEVEALLSSID,-1,-0.76302654,-1,0
P0A3N9,MKRFRIVAPLALMSLALAACETTGPGSGNAPIIAHTPAGIEGSWVDPNGIASSFNGGIFETRTTDTNEKL,-1,-0.7369321,-1,0
P0C109,MGISKASLLSLAAAGIVLAGCQSSRLGNLDNVSPPPPPAPVNAVPAGTVQKGNLDSPTQFPNAPSTDMSA,-1,-0.7448942,-1,0
Q926C0,MRVSHAAAGLAVVLALTGCQRTSFGGFGSQDVSRAPAPLQAQPVPSVSAGQLPPPAGASQFPAAPTTGTA,-1,-0.6207027,-1,0
C4PRC2,MKKTALLAALCSVVSLSSCCRIVDCCFEDPCAPIQCSPCESKKKDVDGGCNSCNGYVPACKPCGGDTHQD,-1,3.4911356,3,4
Q98F85,MGRIAALTRNPVMIALVAMLAIAGCASKKTPNNAADLGLNGAGAATPGSAQDFTVNIGDRIFFDTDSSSI,-1,-0.7401895,-1,0
Q49410,MLFKKFTWVIPSLFLTIISTSLLISCATKSDNTLIFNISLDHNADTSIEKFFTVFSKKLSGKLNKKINVN,-1,-0.7617159,-1,0
P0DI99,MKIKKIKLLKALALTGAFGIVATVPVIVYSCSSTDNNGGTGDNNTGGGGSGTDQQQGTTYTPAIKSDVTL,-1,-0.4272938,0,1
P15363,MLKKLKNFILFSSIFSPIAFAISCSNTGVVKQEDVSVSQGQWDKSITFGVSEAWLNKKKGGEKVNKEVIN,-1,-0.74278176,-1,0
P11221,MNNVLKFSALALAAVLATGCSSHSKETEARLTATEDAAARAQARADEAYRKADEALGAAQKAQQTADEAN,-1,-0.654669,-1,0
P0ADB3,MNKNMAGILSAAAVLTMLAGCTAYDRTKDQFVQPVVKDVKKGMSRAQVAQIAGKPSSEVSMIHARGTCQT,-1,-0.68462145,-1,0
F4LAC2,MTQYFRSLAFFLLPVPATAMACDGWPSWARGACQRVDQIWNEGGNDLYLTGYSWHNRAMYSSDKIRSFNE,-1,-0.62014234,-1,0
D0FUE8,MKLKPVLYLLMLLGCLGLKSAHAATLAHGISASWHSFSQTWNEPQTFDPYIPSIIWHNRWTYDADKIDKY,-1,-0.7217566,-1,0
Q98EC1,MNFSKSGLVAVSLAALVASGCSTSRFSSMDDQQPAPLQPAPAGQVTSNQLPPPASPGSTDPSKFPTAPAN,-1,-0.6811363,-1,0
Q89AJ5,MKSKKIFKILTLLLPMITTFSCSFPKNKLNSNNVDTFYEQETNKSKQQLTNFSEDNFDETLEKLKKGNTI,-1,0.37703958,0,1
P26493,MKAGSFYKLGLLVASAVLVAACSKTPGSADGGAAVGDGDATAQGLGQMTHFAGQEPGESYTTQAPHNQLY,-1,-0.7646728,-1,0
Q98H63,MTIARKVLSIGMAGSFAMMLAACTTSGPDAPPMAAAPKGVEGSWIDAKGTGLSTFTAGKFATVATDTGQK,-1,-0.81085634,-1,0
E4QEX4,MYKNGFFKNYLSLLLIFLVIACTSKDSSNEYVEEQEAENSSKPDDSKIDEHTIGHVFHAMGVVHSKKDRK,-1,-0.76697,-1,0
Q51886,MKKLTKVLLVAGSVAVLAACGSSKKDESAGQMFGGYSVQDLQQRYNTVYFGFDKYNIEGEYVQILDAHAA,-1,-0.8030798,-1,0
Q01567,MHVSSLKVVLFGVCCLSLAACQTPAPVKNTASRSAASVPANEQISQLASLVAASKYLRVQCERSDLPDDG,-1,-0.59108996,-1,0
P0C0J7,MLRKKFLYSSAIYATSLASIIAFVAAGCGQTESGSTSDSKPQAETLKHKVSNDSIRIALTDPDNPRWISA,-1,-0.75249475,-1,0
P0A914,MQLNKVLKGLMIALPVMAIAACSSNKNASNDGSEGMLGAGTGMDANGGNGNMSSEEQARLQMQQLQQNNI,-1,-0.7664789,-1,0
P58042,MRKLKMMLCVMMLPLVVVGCTSKQSVSQCVKPPPPPAWIMQPPPDWQTPLNGIISPSGNDW,-1,-0.5488014,-1,0
C1P601,MRNRNLLKFLPGLLICLIVLTSCVPKQKNMPYALTQRSIPQILPLPSEAKQPKPPKECSPTCSEILQQKL,-1,-0.76618373,-1,0
Q8ZL65,MHKNGKFIPLLALGFTFFLSGCDYFADKHLVEEMKEQQKEQETKINLLEKQQKEQEAKINLLEKQQATII,-1,-0.77228874,-1,0
A7LXT5,MRIFMKSKLLVIATTALLFAACSDSFLDRAPEGNYVDATFYTSDEALEAATAPLYNRAWFDYNQRSIVPI,-1,-0.7612825,-1,0
P0C6Q7,MVVRYSLLMKVSFAILIFLVGCNENATSSNDQYLTDPDISEQTKKPSRPIIDEKNKGVTDTSVTIEWDKI,-1,-0.6931442,-1,0
P29481,MKKTIISTLVIGLVSGCSNTNLLKDNLASEQSVINLSKSSNEAKSRNIEFLSGAYLSERKVPKHDIKFSG,-1,-0.79733586,-1,0
P18164,MKKKLFFALLVLILSSCSLFFQKEYGTITIDLEGGRARSINSSTGLPNLADSELEIDILTEGNSSIYKKI,-1,-0.5437473,-1,0
Q7DDE8,MKPLILGLAAVLALSACQVQKAPDFDYTSFKESKPASILVVPPLNESPDVNGTWGVLASTAAPLSEAGYY,-1,-0.6353818,-1,0
P75062,MFGKGLVKKSLLFFSGVSTMAVFLVSCGATRIWESSIQLLVSNDEATLADKSFSEMSYEGIRRYFRSQKH,-1,-0.74877846,-1,0
C0QY54,MRKTVKIITSLVLIACLFLLASCANKGSSSSGDATTLKVAVMPFLNSVPIEYMINNKLDEKYGFKIETVY,-1,-0.72363037,-1,0
Q9PLJ2,MKKFVYKYSFGALLLLSGLSSCCPSSYGSTPAKNTAEIKEESVILREEPESGCKKKSSCCLRKFFSRKKP,-1,-0.69493556,-1,0
Q7DDH4,MKTVSTAVVLAAAAVSLTGCATESSRSLEVEKVASYNTQYHGVRTPISVGTFDNRSSFQKGIFSDGEDRL,-1,-0.66974044,-1,0
P64654,MYRRLLLNLFCMVFLQACLKPMSDPKAEKVDSQVQCGFGSKDC,-1,0.5458577,1,2
P08452,MLGRSLTSVLIVPTGIGCAVGGYAGDALPLARAIASVSDRLITHPNVMNGASLYWPLPNVAYVEGYALDR,-1,-0.76684463,-1,0
P44125,MKKWLLIIAGALIISACANKDVYFNGAEGSHSGVKFDKDSRQWGLNQ,-1,-0.7615847,-1,0
Q57519,MINRKILLTSLLLIFTVLSACSREKNTCRVVKISDGDTLTCLTKGNKSIKVRLAEIDAPEKSQAFGQKSK,-1,-0.7441813,-1,0
Q9CKU6,MKQKYLFIASMALAGCGSMSESNKYWIQYKDIDQSVKEVSFWSREQFHSPSDVKGTVYQRDNLTHLATST,-1,-0.8284061,-1,0
O51059,MKQKYENYFKKRLILNLLIFLLLACSSESIFSQLGNLQKIKHEYNILGSSSPRGISLVGETLYIAAMHLF,-1,-0.22935902,0,1
Q9CLP1,MHIIKTLISVGVAFSLSACLSLEGVEIAGLEGKSSGTLTKYRCENGYKASIKQRDNGVVSIAFNDGKDSY,-1,0.5234024,1,2
P47590,MKRLFWNLKHKKAWLVLLLGTGMILSSCSNIDQSFFRELSVESVEKNTAYNQLPVNSTTFRNLVFGTRSY,-1,-0.728064,-1,0
O83475,MRRIVCPPVLFLSASLLTGCDFSGIFASIQSEVPLKIPSIRGVVTGLVKCNNKLYACAGQLWEKDASKSE,-1,-0.7095847,-1,0
O83516,MYAGGRVVRSAFARGKVCYLIGSVLWGSVSCTQPRVQKWVQNDGKVNVHSPQERAGVVATFGTVRITRSD,-1,-0.20124586,0,1
P47677,MKLRKIFLLPLISLSTLSVACSSTDPGLEKAQAYFQRNNIELSKNNAVTFLKKGYSSDKEEVINTVFASW,-1,-0.54720104,-1,0
Q50335,MGFKLKGFGFLTLFASQAFLTACSATLTVANTNHKNESDKFVIFEPQPPLSQTIPKPEAEPVIEPDAVAT,-1,-0.76902485,-1,0
P70837,MNSKFILKYFILAFFLVSCQTYQIAYDRFSQVLDSQYDIGVNYSRDGIFKSVISIKYDKLKNKREYFILV,-1,-0.7323394,-1,0
P47580,MAHRFKRWSLIALAFSGVGATAIITACSTINTANLFPTLNRSQKLIGFSDQNIINPDVVLKSALNDGSGV,-1,-0.7194344,-1,0
Q50337,MPITKATPLFLRYRLKGFVFLTLLLVQGVFTACAPAVPVNNKSVSAVQPEDKQALKPDPALGEYTSDLKF,-1,0.5066058,1,2
Q9Z731,MKRVIYKTIFCGLTLLTSLSSCSLDPKGYNLETKNSRDLNQESVILKENRETPSLVKRLSRRSRRLFARR,-1,-0.7110859,-1,0
O83463,MNGKQCFCFFLFHLFYTGLFACGKPESSLAPEYFDLAHAYVQLHRYDEARDYYMRAARDPAYYHAAQYNF,-1,-0.5718284,-1,0
P55561,MSRNDARYLRCTAALGAAFFACGAAAAELTSPPVAPATEGVAAGLSPWQIRVRGLGVLTEDSGSINGVPG,-1,-0.39096543,0,1
P55703,MTLRIIAHLLALTASLAGCTSTAPIYVEQPTPIFVRQESTVLKLESFHASEQQRLLAFLWKASRGRRDAL,-1,-0.68250257,-1,0
P75195,MLVVFKRLGFIVSIFSLTFLSACAAFDKWQEFYINNIPSSTEIHRFNYDLNFSLTFTNRITSNGEAKFSV,-1,-0.7556884,-1,0
P0ADA6,MFKKILFPLVALFMLAGCAKPPTTIEVSPTITLPQQDPSLMGVTVSINGADQRTDQALAKVTRDNQIVTL,-1,-0.78293353,-1,0
P45301,MTLSPLKKLAILLGATIFLQGCVAAVIGGGAVAAKVATDPRTTGTQIDDETLEFKVENAVEKDAQIKAEG,-1,-0.4758474,0,1
P45615,MKRTIKYLSFLGLIPFLSITTISCVKQAKENNNKNQLISQFKQLIFILNSFDLDNKKLESKIIKAIEKSD,-1,-0.7373562,-1,0
Q50339,MRLQFKLLGFLTLLGTSTILSACAATQPNFEPNNIEESGPITPTTPTTDVPKPTAEVVPVNRGFHFQTNK,-1,-0.69921505,-1,0
O66867,MKKALFLVGLVFTAGVISSCGGVSSQRTYEGAAVGAAVGAAAGVLLDKENRWRGGVIGAALGAILGGTIT,-1,-0.72179663,-1,0
Q68WW6,MLKKIIILFLGIFLLSSCTDNFRNYFQRSANNKLFDVKGAKGGKRKPVYNNKYIALAKKNIVEDNIDYDN,-1,-0.7120102,-1,0
P45492,MKKGIFLSIGIAVLFSACGNSIDEKTVKKYENQLNQTVKQEIASLSQDSGIKIEFSDFKCNADGDFIACL,-1,-0.80467427,-1,0
P77339,MNSKKLCCICVLFSLLAGCASESSIDEKKKKAQVTQSNINKNTPQQLTDKDLFGNETTLAVSEEDIQAAL,-1,-0.7297457,-1,0
P75737,MKTNRSLVVIVSLITATLLLTACAQPEQSSLAGDWLLTPKDKTRGLTGSIAVNIAPFRCKTNCRGDNLPD,-1,-0.73960495,-1,0
P43997,MTMFKKISVLFFTLILAGCSSWSSVTNYIPFMGNDKKVIDLDKDKIDQKSYAAAYEATVATYKGRVNENF,-1,-0.81014156,-1,0
P33668,MKYSSIFSMLSFFILFACNETAVYGSDENIIFMRYVEKLHLDKYSVKNTVKTETMAIQLAEIYVRYRYGE,-1,-0.7665421,-1,0
Q9CMX6,MRQYTSKSILFMTAIALSACSHLPQTTSQGATVVSAQTVTQALGVDLASLEQKATALKPFEYIHNQDHYI,-1,-0.73118937,-1,0
O83908,MKFCRGWRGARAGQFARLLCVCWCSLGACSCVRESTERSGVVPISPSSQQKVLFVFGKKYSGHVYLVDCV,-1,-0.71880037,-1,0
O83469,MNTRLALVLCAVGSGVLSFSCARTAEPTPAASTHVPVTTAGALSVTPPSSTDRWYQFSRTDGRVHLRACP,-1,6.400286,6,7
Q9CN84,MKKAAVLAVVLSLGLAGCSKNYNDQYHGNGYRAEILFSEYNGENLTLTVRKNNCEHEDGPIETIQIGHKY,-1,-0.7432815,-1,0
P47635,MLKIDMWFKLKSLGFSLISLQALLASCSAVSPVPVPIEEKNDSTTDNNATPFKDEQSDQGTEVNQQPKVE,-1,-0.7228079,-1,0
P65291,MMKFKKCLLPVAMLASFTLAGCQSNADDHAADVYQTDQLNTKQETKTVNIISILPAKVAVDNSQNKRNAQ,-1,-0.7696221,-1,0
Q46835,MSIKQMPGRVLISLLLSVTGLLSGCASHNENASLLAKKQAQNISQNLPIKSAGYTLVLAQSSGTTVKMTI,-1,-0.7144936,-1,0
P37665,MKKRVYLIAAVVSGALAVSGCTTNPYTGEREAGKSAIGAGLGSLVGAGIGALSSSKKDRGKGALIGAAAG,-1,-0.733836,-1,0
P0ADM4,MIRNVLLAFMICSGMTLLGGCSSVMSHTGGKEGTYPGTRASATMIGDDETNWGTKSLAILDMPFTAVMDT,-1,-0.2592485,0,1
O83691,MDRFFCTVWVWSVLFGACTSQTRSSFSLNADGLNSSGVAHASEHVSHAAAMGNEAGAADASVSESPASFS,-1,-0.6246214,-1,0
P40822,MKKFFFAAALVVSGLLVGCNQLTQYTISEQEINQALEKRNNFSKDIGLPGIADAHIVLTNLVSQIGREEP,-1,-0.752522,-1,0
O83811,MDKKARAHTVIVCLVGALSLACAYLLGGSMKYLRGDVSRFWTSSRMQRHPAHSSQPVVRTFTDADGYTCL,-1,5.309668,5,6
P37056,MDKPKAYCRLFLPSFLLLSACTVDISQPDPSATAVDAEAKTWAVKFQHQSSFTEQSIKEITAPDLKPGDL,-1,-0.7798885,-1,0
P77365,MKRKTLPLLALVATTLFLIACDDRSDDLKAISKFKDLTPPRFSDVVSHQDDVSEEWSQVDYLSGPTLQVL,-1,-0.72924113,-1,0
P46122,MNTNVFRLLLLGSLFSLSACVQQSEVRQMKHSVSTLNQEMTQLNQETVKITQQNRLNAKSSSGVYLLPGA,-1,-0.3764328,0,1
P75818,MRYSKLTMLIPCALLLSACTTVTPAYKDNGTRSGPCVEGGPDNVAQQFYDYRILHRSNDITALRPYLSDK,-1,-0.80183554,-1,0
Q8CW29,MDICSRNEKLAIRRPAILVALALLLCSCKSTPPESMVTPPAGSKPPATTQQSSQPMRGIWLATVSRLDWP,-1,-0.75762266,-1,0
P32051,MNRIYRVIWNCTLQVFQACSELTRRAGKTSTVNLRKSSGLTTKFSRLTLGVLLALSGSASGASLEVDNDQ,-1,0.09367938,0,1
Q7VQ46,MNKRTLLFVSLIGIAFVGCQIFFGYNEFRSCKNLAEKQRKISEQTLAAVESVGLSVASWDTDVNGEEHKN,-1,-0.6233144,-1,0
P0AA91,MAVQKNVIKGILAGTFALMLSGCVTVPDAIKGSSPTPQQDLVRVMSAPQLYVGQEARFGGKVVAVQNQQG,-1,-0.63349175,-1,0
P0AD46,MRHIFQRLLPRRLWLAGLPCLALLGCVQNHNKPAIDTPAEEKIPVYQLADYLSTECSDIWALQGKSTETN,-1,-0.7735126,-1,0
P0A1T6,MKNVFKTLAVLLTLFSLTGCGLKGPLYFPPADKNAPPPTKKVDSQTQSTMPDKNDRATGDGPSQVNY,-1,-0.7636864,-1,0
P44084,MKKYFLILASFMLVACSSSEQNLTYSTKPILNITSSLSPLIQVETTQKSAVIKNKSQQLLNISYHLYWYD,-1,-0.77564,-1,0
P0AF70,MHVKYLAGIVGAALLMAGCSSSNELSAAGQSVRIVDEQPGAECQLIGTATGKQSNWLSGQHGEEGGSMRG,-1,-0.78325796,-1,0
P31063,MKKLAIAGALLLLAGCAEVENYNNVVKTPAPDWLAGYWQTKGPQRALVSPEAIGSLIVTKEGDTLDCRQW,-1,-0.7656069,-1,0
P76578,MKKLRVAACMLMLALAGCDNNDNAPTAVKKDAPSEVTKAASSENASSAKLSVPERQKLAQQSAGKVLTLL,-1,-0.7285993,-1,0
P0AB11,MKKWLVTIAALWLAGCSSGEINKNYYQLPVVQSGTQSTASQGNRLLWVEQVTVPDYLAGNGVVYQTSDVK,-1,-0.7726394,-1,0
Q8XBJ0,MKRTMLYLSLLAVSCSVSAAKYPVLTESSPEKAGFNVERLNQMDRWISQQVDAGYPGVNLLIIKDNQIVY,-1,-0.2596603,0,1
P07021,MIKHLVAPLVFTSLILTGCQSPQGKFTPEQVAAMQSYGFTESAGDWSLGLSDAILFAKNDYKLLPESQQQ,-1,-0.7787792,-1,0
P75801,MSRINKFVLTVSLLIFIMISAVACGIYTQMVKERVYSLKQSVIDTAFAVANIAEYRRSVAIDLINTLNPT,-1,-0.52078944,-1,0
P65293,MKKTAAIISACMLTFALSACSGSNYVMHTNDGRTIVSDGKPQTDNDTGMISYKDANGNKQQINRTDVKEM,-1,-0.7662871,-1,0
Q8YDY8,MRTLVMVACAVSLAACSSPPKPPTVSGRHRIPINSPAAQEELRLQVFPQEPTAQATMWPARPPKQTVNVY,-1,-0.512327,-1,0
B7URS4,MKYKLLPCLLAILLTGCDRTEVTLSFTPEMASFSNEFDFDPLRGPVKDFTQTLMDEQGEVTKRVSGTLSE,-1,-0.716614,-1,0
P43319,MKRAPLITGLLLISTSCAYASSGGCGADSTSGATNYSSVVDDVTVNQTDNVTGREFTSATLSSTNWQYAC,-1,-0.20954134,0,1
Q46798,MSAGRLNKKSLGIVMLLSVGLLLAGCSGSKSSDTGTYSGSVYTVKRGDTLYRISRTTGTSVKELARLNGI,-1,-0.7026232,-1,0
P64451,MRTTSFAKVAALCGLLALSGCASKITQPDKYSGFLNNYSDLKETTSATGKPVLRWVDPSFDQSKYDSIVW,-1,-0.70487857,-1,0
P78067,MKRVSQMTALAMALGLACASSWAAELAKPLTLDQLQQQNGKAIDTRPSAFYNGWPQTLNGPSGHELAALN,-1,19.201153,19,20
A1AIS9,MPTVLSRMAMQLKKTAWIIPVFMVSGCSLSPAIPVIGAYYPGWFFCAIASLILTLITRRIIQRTNINLAF,-1,-0.53631055,-1,0
O32528,MKVNLILFSLFLLVSIMACNVFAFSISGGGSERSYKETEKTSAMTTTHSTKLQPSQAILFKMREDAPPLN,-1,16.475388,16,17
P58337,MRYTFGIVTVYLLAGCAGSPPKPPEVKGKYRPINRVEAPASAGRNPVNSLNALCGNLNEKQCR,-1,-0.8026118,-1,0
Q9JMT5,MFNRRVLFLSVFSCAVFMLSGCSSNRFASRDANATYVNTQLKIIPRSQEKIQAQSQCSRSFSLLQKLNTD,-1,-0.8195619,-1,0
O67998,MIRRRYRGCTQGAWIVSVGMLFASCTSGAWKASVDPLGVVGSGADVYLYFPVAGNENLISRIIENHESKA,-1,-0.7726947,-1,0
Q8RMH6,MKITLRMMVLAVLTAMAMVLAACGGGGSSGGSTGGGSGSGPVTIEIGSKGEELAFDKTELTVSAGQTVTI,-1,-0.5814033,-1,0
P07173,MKQLIVNSVATVALASLVAGCFEPPPATTTQTGFRGLSMGEVLHPATVKAKKERDAQYPPALAAVKAEGP,-1,-0.52205205,-1,0
P07206,MLRYTRNALVLGSLVLLSGCDNGSSSSSSGNPDTPDNQDVVVRLPDVAVPGEAVTAVENQAVIHLVDIAG,-1,-0.8312795,-1,0
P07643,MNAHTLVYSGVALACAAMLGSCASGAKEEAEKKAAEQRALLVESAHADRRLMEARIGAQESGADTQHPEL,-1,7.775496,8,9
P09181,MCGKILLILFFIMTLSACQVNHIRDVKGGTVAPSSSSRLTGLKLSKRSKDPL,-1,-0.4981512,0,1
P0A139,MEMLKFGKFAALALAMAVAVGCSSKGGDNAGEGAAVDPNAGYGANTGAVDGSLSEEAALRAITTFYFEYD,-1,-0.72668207,-1,0
P11910,MKKSLFAAALLSLALAACGGEKAAEAPAAEASSTEAPAAEAPAAEAPAAEAAAAEAPAAEAPAAEAPAAE,-1,-0.7802509,-1,0
P16055,MVKRGRFALCLAVLLGACSFSSIPNGTYRATYQDFDENGWKDFLEVTFDGGKMVQVVYDYQHKEGRFKSQ,-1,-0.64123905,-1,0
P17323,MKRLFLSFVALALLAGSIAACGQKGPLYLPDDEKAKKEHSKDRYGF,-1,-0.36269507,0,1
P19478,MKRVSLLGSAAIFALVFSACGGGGEHQHGEEMMAAVPAPDAEGAAGFDEFPIGEDRDVGPLHVGGVYFQP,-1,-0.7894988,-1,0
P26093,MKTTLKMTALAALSAFVLAGCGSHQMKSEGHANMQLQQQAVLGLNWMQDSGEYKALAYQAYNAAKVAFDH,-1,-0.69611794,-1,0
P29722,MKGSVRALCAFLGVGALGSALCVSCTTVCPHAGKAKAEKVECALKGGIFRGTLPAADCPGIDTTVTFNAD,-1,8.808269,9,10
P29723,MKVKYALLSAGALQLLVVGCGSSHHETHYGYATLSYADYWAGELGQSRDVLLAGNAEADRAGDLDAGMFD,-1,-0.6920575,-1,0
P33950,MKLKATLTLAAATLVLAACDQSSSANKSTAQTEAKSSSNNTFVYCTAKAPLGFSPALIIEGTSYNASSQQ,-1,-0.7479867,-1,0
P38371,MTKNIVNTALVLVGAGSLLTGCNFEQPETNCFVQESPSWAVKYDVVDSPKDANGDECTTTAPLVELMGVY,-1,-0.2201118,0,1
P40710,MVKKAIVTAMAVISLFTLMGCNNRAEVDTLSPAQAAELKPMPQSWRGVLPCADCEGIETSLFLEKDGTWV,-1,-0.7150063,-1,0
P41069,MKQTSFFIPLLGTLLLYGCAGTSTEFECNATTSDTCMTMEQANEKAKKLERSSEAKPVAASLPRLAEGNF,-1,-0.72665364,-1,0
P77717,MKLVHMASGLAVAIALAACADKSADIQTPAPAANTSISATQQPAIQQPNVSGTVWIRQKVALPPDAVLTV,-1,-0.73847127,-1,0
Q02937,MNIATKLMASLVASVVLTACSGGGSSGSSSKPNSELTPKVDMSAPKAEQPKKEEVPQADNSKAEEPKEMA,-1,-0.68741137,-1,0
Q59514,MQRRHFLQKTLLALPIIFSGNLLTGCKTNLSDDYLPDDKITNNPNLLQNKLKEILPIWENKFNAKIGMTI,-1,-0.8021139,-1,0
Q9K1P6,MRKFNLTALSVMLALGLTACQPPEAEKAAPAASGEAQTANEGGSVSIAVNDNACEPMELTVPSGQVVFNI,-1,-0.69552666,-1,0
Q9Z6M6,MISFRFLLLSGLCALGISSYAETPKETTGHYHRYKARIQKKHPESIKESAPSETPHHNSLLSPVTNIFCS,21,18.7692,19,2
Q9LCB9,MKKLAKMISVATLGACAFQAHALDGKLVPDQGILVSVGQDVDSVNDYSSAMGTTPAGVTNYVGIVNLDGL,22,16.353832,16,6
P39180,MKRHLNTCYRLVWNHMTGAFVVASELARARGKRGGVAVALSLAAVTSLPVLAADIVVHPGETVNGGTLAN,52,35.190704,35,17
Q9LAP7,MFKTKRSLLNSSIAISFAVLGVQAQAETLELQAESFANSGGTYSDGQPNPVTIYNVNGQGAINFVNAGDY,26,23.591486,24,2
P0AD70,MKRSLLFSAVLCAASLTSVHAAQPITEPEFASDIVDRYADHIFYGSGATGMALVVIDGNQRVFRSYGETR,21,17.924145,18,3
P95470,MPTHHPITRQHWHHSWLSALALLCASLACGAKQVDVHDPVMTREGDTWYLFSTGPGITIYSSKDRVNWRY,31,14.819304,15,16
A0A0A1H8I4,MFPRLPTLALGALLLASTPLLAAQPVTTLTVLSSGGIMGTIREVAPAYEKATGVKLDIAAAPSMGDTPQA,22,22.245943,22,0
Q51372,MKTRTSRLFRLSALAAGLCLAQAALAADPGAAPSYQALPAGNLCPAAAYDSRYNTKYLGFFTHLVQAQDD,26,27.984255,28,2
I0J1I6,MPFSRTLLALSLGMALLQNPAFAAPPLSMTDGVAQVNTQDSNAWVEINKAAFEHNIRTLQTALAGKSQIC,23,19.680801,20,3
Q52VH2,MTSTQRLWSGALPLLTALIVSIAATASLAGPRARDLGVPFEGTPGALNAITDVAGVEVGHTTVISGDGAM,29,24.32846,24,5
Q9I589,MKHYSATLALLPLTLALFLPQAAHAHGSMETPPSRVYGCFLEGPENPKSAACKAAVAAGGTQALYDWNGV,25,23.355854,23,2
Q47910,MNFKSTVITAMCCFFSFAVLASEKLEKPKLVVGLVVDQMRWDYLYRYYDRYSENGFKRLLNEGFSSENTL,21,21.093273,21,0
P59807,MPIFRFTALAMTLGLLSAPYNAMAATSNPAFDPKNLMQSEIYHFAQNNPLADFSSDKNSILTLSDKRSIM,24,20.369038,20,4
Q05JY7,MKIKILSAMIASSLLIGCVIPTVKASQSAIKSIETNRTITKVRTGMLSGGSSIITTSYEGTVAAYKFNGE,25,-0.5230654,-1,26
Q9KK91,MDKMFKRTVIGAAVALASTGLMAKEVGVNSDFNVDVYGVAAMSVVNYNTTDNRDDSSGYVLENESRIGFR,23,17.30399,17,6
Q7CQY4,MRTFSGKRSTLALAIAGITAMSGWIVVPQAQASGFFDDSTLTGGIYYWQRERDRKDVTDGDKYKTNLSHA,32,27.674004,28,4
Q9HU05,MRPSFASWGLLALLLLQGPLLQAQPLSPALQQLLSLSSQRLQLADQVAQSKAQSGKAVQDSPREEQQLQM,23,20.74116,21,2
P96156,MRLHRAKVSKSVFTLSTLTASCLMAFNSYAAVDCSALAEWQSDTIYTGGDQVQYNGSAYQANYWTQNNDP,30,32.342354,32,2
Q9F437,MKVRCVSLVAAGLLTIAGSAIGQPAPAPMPAMAPAAKPAMNTPVDRAKILSAPGVFVAFSTYKIRPDYFK,38,21.042038,21,17
Q6F3I7,MRLALFALFALMTVATALPAHAEKLTLEAITGSAPLSGPTLTKPQIAPDGSRVTFLRGKDRDRNRLDLWE,22,18.384094,18,4
O07834,MKPTSLLLAATVLMSTPITSALAASATPPDVAKKPHVVKAPHGAERNDEYYWLRDDKRENKEMLAYLNAE,23,19.369137,19,4
Q727P6,MRYLVISLFAVSLLMAGSALVGNAADAAKAPKKAIELKHGTSKRMHVMFNHTTHKDIACEQCHHDSPAPD,24,18.704092,19,5
P80549,MAFTAMTVAPSALADLVLAQKSGCTVCHSVEAAIVGPAYKDVAAKYRGDAAAQDRLVAKVMAGGVGNWGQ,14,15.0827465,15,1
V5YM14,MRPNLLAAAIAVPLSLLAAQIAQAGEGMWVPQQLPEIAGPLKKAGLKLSPQQISDLTGDPMGAVVALGGC,24,20.198467,20,4
F8WQK8,MNKRFFPTLLLAFVCSTLAYADGGMWLMQQINGQVARMKSLGMQLEAADIYNPNGSSLKDAVVMFDGGCT,21,20.566896,21,0
Q99PX1,MKLNKLAIATLVSAALSQYAFAQTDTKGTIYLTFDDGPINASIDVINVLNQEEVKATFYFNAWHLDGIGD,22,19.255394,19,3
Q47952,MKANKLSAITLCILGYAHTVYAESNMQTEKLETIVVSSEDDSVHNKNVGEIKKNAKALSKQQVQDSRDLV,22,19.661331,20,2
P16466,MKSKNFKLSPSGRLAASLAIIFVSLNAYGNGIVPDAGHQGPDVSAVNGGTQVINIVTPNNEGISHNQYQD,29,31.11633,31,2
E1V825,MKKTLLATAIAGAMAASGAQAATVYNQDGTKLDIYGNVQIGFRNIEAENDNGNIETQNDVFDNGSTIGFA,21,16.166336,16,5
Q9HZQ8,MSNKNNLRYALGALALSVSAASLAAPSEAQQFTEFWTPGKPNPSICKSPLLVSTPLGLPRCLQASNVVKR,24,24.770996,25,1
E1XUJ2,MRFTLKTTAIVSAAALLAGFGPPPRAAELPPGRLATTEDYFAQQAKQAVTPDVMAQLAYMNYIDFISPFY,26,20.045637,20,6
B2RIT0,MNKKIFSMMAASIIGSAAMTPSAGTNTGEHLTPELFMTLSRVSEMALSPDGKTAVYAVSFPDVKTNKATR,24,23.414122,23,1
P36911,MKKFINQFSASLKNNILVFLAFPFVWTSCARDNPLSSENSNISPNAAARAAVTGTTKANIKLFSFTEVND,50,-0.53566396,-1,51
Q9EZE7,MNKIYALKYCHATGGLIAVSELASRVMKKAARGSLLALFNLSLYGAFLSASQAAQLNIDNVWARDYLDLA,53,35.78178,36,17
C6XZB6,MKRQLYLYVIFVVVELMVFTTKGYSQTKADVVWKDVDGVSMPIPPKTHPRLYLREQQVPDLKNRMNDPKL,25,21.399765,21,4
Q59289,MTTKIFKRIIVFAVIALSSGNILAQSSSITRKDFDHINLEYSGLEKVNKAVAAGNYDDAAKALLAYYREK,24,23.165073,23,1
Q9ZG90,MRKTKFWLVLSLIATSLSIFACKKDSTATKNPIPEVSKAKASTKLLNATTVATTDYELIWSDEFNSSGGF,46,-0.47436538,0,46
Q7MSJ8,MLSGWSVLKGGNMKYWDKALLSLFMCVSTLSIAATHAVAMEGMQMTKEAREIIAHPKGTKESRGVISLQD,39,34.037395,34,5
P44654,MINMTKQVSKILAGLFTALFAGSLMASDAPAVGKDLTQAAENIPPAFHNAPRQGELPALNYVNQPPMVPH,26,26.774277,27,1
L0DSL2,MNDLNRLGRVGRWIAGAACLFLASAAHAEPGENLKPVDAMQCFDCHTQIEDMHTVGKHATVNCVHCHDAT,28,26.918587,27,1
Q588Z2,MFKPVVKSRSSRSFCYLAGCLAMVAATLSSTAQAKSEWACPEGFTPKAGLNTDFPSDGKKRAFVVVPPKD,34,30.157967,30,4
P38008,MIKRTSLSFACLSFFYLSTISILQANETDTLQFRRFTFSDREIQFVLDPASLITAQNIVLSNLQSNGTGA,25,20.088663,20,5
K4LAH1,MYKRSLIAASLSVAALVSAQAMAEINGGGATLPQQLYQEPGVLTAGFAAYIGAGSGNGKAAFLNNDYTKF,23,19.126831,19,4
Q588Z1,MGSHAWGGAVFSAATLIAFGSVVHASGTVAETAPQSGHAVPADQLDGETLYKARCAACHDNAEGRTPSRE,32,24.138863,24,8
P09489,MILNKRLKLAYCVFLGCYGLSIHSSLAAYQDPGRLGAPDSWKTAEFNRQWGLEAISAEFAYARGYTGKGI,27,10.725358,11,16
P0DMR4,MKLKRLMAALTFVAAGVGAASAVAAIDPALPEYQKASGVSGNLSSVGSDTLANLMTMWAEEYKRLYPNVN,24,20.467163,20,4
Q8GR64,MKKPLRTSLLMLCLATPLAALAAGVDEAAIRATEQAGGEWLSHGRTYAEQRFSPLKQIDASNVRSLGLAW,22,21.561447,22,0
P64534,MTIKNKMLLGALLLVTSAAWAAPATAGSTNTSGISKYELSSFIADFKHFKPGDTVPEMYRTDEYNIKQWQ,25,22.023197,22,3
D7A6E5,MRRFAAGCLALALLVLPFVLTGARAAEDESEKEIERYRQMIEDPMANPGFLNVDRGEVLWSEPRGTRNVS,25,21.963219,22,3
Q08IS0,MKKTVTAVALLCALSSTAIAPTFAADDDEAARLKAIEEYRKQIADGNPSDLLAMEGEELWRTPYGPKNQS,24,18.783113,19,5
Q939U1,MKTMTGRLVAAALVCGGAFSGAAVSAGPDDPLVINGEIEIVTRAPTPAHLADRFDEIRSGWTFRTDDTQA,26,22.205738,22,4
Q8RLX0,MKKTIQRGLFTGALVLLTAMTSKPAHAAVNYQALVDADVKKFQGYFLKEFPGVKLEDFGDGVYALDEDSR,28,25.406204,25,3
E1VBK1,MKAYKLLTTASIGALMLGMSTAAYSDNWRYAHEEYEGDVQDVFAQAFKGYVEDNSDHTVQVYRFGELGES,25,23.211859,23,2
Q47692,MNRIYSLRYSAVARGFIAVSEFARKCVHKSVRRLCFPVLLLIPVLFSAGSLAGTVNNELGYQLFRDFAEN,52,36.630974,37,15
D3RVD4,MRGDVRVHTASPIAAAWLLAVGLVAHAEEPPTVALTVPAAALLPDGALGESIVRGRRYLSDTPAQLPDFV,27,29.03442,29,2
Q9RUE8,MKKFAAVLGLTVAFAAASQAHAVTLTFACDSVGQGFDECKKGADAWAKKTGNTVKLVQVPKESDARLALY,24,20.128338,20,4
Q48245,MEIQQTHRKINRPLVSLALVGALVSITPQQSHAAFFTTVIIPAIVGGIATGTAVGTVSGLLGWGLKQAEE,33,33.923553,34,1
Q51227,MKKTVFTCAMIALTGTAAAAQELQTANEFTVHTDLSSISSTRAFLKEKHKAAKHIGVRADIPFDANQGIR,-1,12.12316,12,13
Q9HWW1,MRKSWLTASLLALTVASPFAAADIQGHKAGDFIIRGGFATVDPDDSSSDIKLDGAKQRGTKATVDSDTQL,-1,19.295307,19,20
Q51486,MKALKTLFIATALLGSAAGVQAADNFVGLTWGETSNNIQKSKSLNRNLNSPNLDKVIDNTGTWGIRAGQQ,-1,18.9135,19,20
Q72JD8,MKKGLLAALAGFLTLAMAQKFSVEAGAGFYGGFGGQLAVVAEDLAPGLPLGVRLGVGFATSDALDDGYDL,-1,17.266985,17,18
Q9HVD1,MKKLLPLAVLAALSSVHVASAQAADVSAAVGATGQSGMTYRLGLSWDWDKSWWQTSTGRLTGYWDAGYTY,-1,18.838013,19,20
G1UBD1,MKTIKDRIAKWSAIGLLSAVAATAFYAPSASAHGEKSQAAFMRMRTIHWYDLSWSKEKVKINETVEIKGK,32,24.283869,24,8
P77338,MTMFQYYKRSRHFVFSAFIAFVFVLLCQNTAFARASSNGDLPTKADLQAQLDSLNKQKDLSAQDKLVQQD,33,32.33502,32,1
Q8UG67,MRMTVIPIVILCGVLSVVYAVWTTKSVLDADQGNERMREIAGYIREGAQAYLTRQYLTIAIVGLIVAVLA,-1,17.139923,17,18
G2JM62,MKVLRVLVTTTALLAAGAAMADEAVVHDSYAFDKNQLIPVGARAEVGTTGYGGALLWQANPYVGLALGYN,-1,18.005436,18,19
P75783,MRWILFILFCLLGAPAHAVSIPGVTTTTTTDSTTEPAPEPDIEQKKAAYGALADVLDNDTSRKELIDQLR,18,17.466805,17,1
P39285,MRLIITFLMAWCLSWGAYAATAPDSKQITQELEQAKAAKPAQPEVVEALQSALNALEERKGSLERIKQYQ,19,17.825073,18,1
Q8ZRJ9,MKNFFAVCIIPLVVAWSATASAKEGIYITGKAGTSVVNVYGINSTFSQDEIVNGHATLPDRTKGVFGGGV,-1,20.378494,20,21
Q55115,MPLPLMMINYSLLLSLALPPIAGGIIGYFTNDLAIKMLFRPYKPLFLGPYQLPFTPGLIPRNQERLAKRV,22,19.730457,20,2
Q03155,MNKAYSIIWSHSRQAWIVASELARGHGFVLAKNTLLVLAVVSTIGNAFAVNISGTVSSGGTVSSGETQIV,52,35.69009,36,16
Q7BCK4,MNQIHKFFCNMTQCSQGGAGELPTVKEKTCKLSFSPFVVGASLLLGGPIAFATPLSGTQELHFSEDNYEK,52,36.07359,36,16
P0AGC7,MARTKLKFRLHRAVIVLFCLALLVALMQGASWFSQNHQRQRNPQLEELARTLARQVTLNVAPLMRTDSPD,30,30.667198,31,1
Q9RP17,MKKALATLIALALPAAALAEGASGFYVQADAAHAKASSSLGSAKGFSPRISAGYRINDLRFAVDYTRYKN,-1,20.30262,20,21
Q8ZPT3,MNKYSYCATMIAAILSTTTMANASSLAISVANDDAGIFQPSLNALYGHPAADRGDYTAGLFLGYSHDLTD,-1,19.582323,20,21
P0A927,MKKTLLAAGAVLALSSSFTVNAAENDKPQYLSDWWHQSVNVVGSYHTRFGPQIRNDTYLEYEAFAKKDWF,-1,17.077402,17,18
P69856,MKKAKILSGVLLLCFSSPLISQAATLDVRGGYRSGSHAYETRLKVSEGWQNGWWASMESNTWNTIHDNKK,-1,20.094112,20,21
Q8GKS5,MRTTPTFPTKTFKPTAMALAVATTLSACLGGGGGGTSAPDFNAGGTGIGSNSRATTAKSAAVSYAGIKNE,18,0.12903254,0,18
Q45340,MYLDRFRQCPSSLQIPRSAWRLHALAAALALAGMARLAPAAAQAPQPPVAGAPHAQDAGQEGEFDHRDNT,28,33.001152,33,5
Q9HVJ6,MPLLCALIVGGLFGTSQAQAGGFMVPTTNTAGWGRAMAGGSLFPNDPSAAFNNPAAMAFIDKRIAQLTVN,-1,18.29594,18,19
Q9RBW8,MKGNYVRAATAICVAICGTHARATDVFNLEGFGPVSRAMGGTGAAFDIGPAAMMENPATLGLMGEGRHFS,-1,-0.6843089,-1,0
P35077,MTDATNRFRPGLVGRALVRAGLLFAVAACAQAQLLPGARDLNRIDDRQRKEQLQRDIERALTRPPVELNP,30,-0.52569926,-1,31
P0ADE4,MRYIRQLCCVSLLCLSGSAVAANVRLQVEGLSGQLEKNVRAQLSTIESDEVTPDRRFRARVDDAIREGLK,21,20.280624,20,1
Q8GNN6,MIKIARIAVTLGLFSSLGAQAYAAGLVVNDNDLRNDLAWLSDRGVIHLSLSTWPLSQEEIARALKKAKPS,21,22.088825,22,1
Q9HVS0,MMRNQRVTSATLGLALLAASAPGWAADEQENPPAPDNPSYAAEVQSIPSVAKPIKGQAGATGLVEGQSLT,-1,21.907612,22,23
P48632,MPAPHGLSPLSKAFLMRRAFQRRILPHSLAMALSLPLAGYVQAQEVEFDIPPQALGSALQEFGRQADIQV,43,8.473505,8,35
P72412,MSRPQFTSLRLSLLALAVSATLPTFAFATETMTVTATGNARSSFEAPMMVSVIDTSAPENQTATSATDLL,28,23.195948,23,5
Q841A2,MSSGLVPRGSGMKETAAAKFERQHMDSPDLGTDDDDKMAENNAKVVLDTVTVKGDRQGSKIRTNIVTLQQ,18,8.82045,9,9
A0A1G7LAS7,MKKLLIASTALVMVAGAAAAEVKLSGDARMGVMYNGDDWNFSSRSRVLFTMSGTTDSGLEFGASFKAHES,-1,17.429949,17,18
Q6B6R8,MIRMALKPLVAACLLASLSTAPQAAPSPYSTLVVFGDSLSDAGQFPDPAGPAGSTSRFTNRVGPTYQNGS,24,20.955708,21,3
